unnecessary	unnötig	A
insane	wahnsinnig	A
dirty	schmutzig	A
obvious	offensichtlich	A
scarce	knapp	A
vintage	uralt	A
rapid	schnell	A
ashamed	beschämt	A
orange	orange	A
happy	glücklich	A
black	schwarz	A
normal	normal	A
pink	rosa	A
graphic	grafisch	A
hot	heiß	A
important	wichtig	A
friendly	freundlich	A
dead	tot	A
bad	schlecht	A
outdoor	im Freien	A
narrow	schmal	A
crazy	verrückt	A
dreary	trostlos	A
great	groß	A
anxious	ängstlich	A
abstract	abstrakt	A
cruel	grausam	A
difficult	schwierig	A
clever	klug	A
tall	hoch	A
broad	breit	A
female	weiblich	A
tropical	tropisch	A
different	andere	A
foolish	töricht	A
underwater	unterseeisch	A
sunny	sonnig	A
glad	froh	A
simple	einfach	A
bold	fett	A
sharp	scharf	A
sure	sicher	A
restless	unruhig	A
blue	blau	A
intelligent	intelligent	A
brown	braun	A
mad	verrückt	A
smart	intelligent	A
exotic	exotisch	A
key	wichtigste	A
cute	niedlich	A
military	militärisch	A
frigid	kalt	A
large	groß	A
white	weiß	A
nice	schön	A
dull	stumpf	A
yellow	gelb	A
old	alt	A
underground	unterirdisch	A
dumb	stumm	A
funny	lustig	A
sweet	süß	A
sexy	sexy	A
wet	nass	A
industrial	industriell	A
fast	schnell	A
afraid	ängstlich	A
rough	rau	A
feline	katzenartig	A
sly	schlau	A
wild	wild	A
laden	beladen	A
modest	bescheiden	A
ancient	alt	A
tough	hart	A
illegal	illegal	A
easy	leicht	A
immoral	unmoralisch	A
urban	städtisch	A
wonderful	wunderbar	A
young	jung	A
cheerful	heiter	A
strong	stark	A
beautiful	schön	A
crucial	entscheidend	A
unhappy	unzufrieden	A
proud	stolz	A
dense	dicht	A
weird	seltsam	A
wide	breit	A
blonde	blond	A
fragile	zerbrechlich	A
pregnant	schwanger	A
uniform	einheitlich	A
quick	schnell	A
bright	hell	A
violent	gewalttätig	A
terrible	schrecklich	A
recent	letzte	A
essential	wesentlich	A
canine	Hunde-	A
honest	ehrlich	A
rare	selten	A
stupid	dumm	A
sick	krank	A
square	quadratisch	A
flexible	flexibel	A
inexpensive	billig	A
modern	modern	A
childish	kindisch	A
harsh	hart	A
heavy	schwer	A
misty	neblig	A
grey	grau	A
proper	richtig	A
nude	nackt	A
tiny	winzig	A
cold	kalt	A
necessary	notwendig	A
confident	zuversichtlich	A
colorful	bunt	A
red	rot	A
odd	ungerade	A
cheap	billig	A
short	kurz	A
small	klein	A
hard	hart	A
certain	sicher	A
strange	seltsam	A
fresh	frisch	A
concrete	konkret	A
new	neu	A
guilty	schuldig	A
noticeable	bemerkbar	A
long	lange	A
green	grün	A
angry	wütend	A
polite	höflich	A
sad	traurig	A
impatient	ungeduldig	A
frozen	gefroren	A
formal	formal	A
bizarre	bizarr	A
generous	großzügig	A
big	groß	A
rusty	rostig	A
huge	riesig	A
purple	lila	A
dark	dunkel	A
aerial	luft	A
awful	schrecklich	A
terrific	großartig	A
downtown	Innenstadt	A
miniature	klein	A
apparent	ersichtlich	A
ceramic	keramisch	A
delightful	wunderbar	A
elastic	elastisch	A
lighthouse	Leuchtturm	N
universe	Universum	N
whiskey	Whiskey	N
essay	Essay	N
belt	Gürtel	N
university	Universität	N
colt	Fohlen	N
pantyhose	Strumpfhose	N
commonwealth	Gemeinwesen	N
lighting	Beleuchtung	N
cube	Würfel	N
duck	Ente	N
pin	Stift	N
insight	Einblick	N
discussion	Diskussion	N
rainbow	Regenbogen	N
prestige	Prestige	N
trail	Weg	N
daffodil	Narzisse	N
tongue	Zunge	N
porch	Veranda	N
choice	Wahl	N
lover	Liebhaber	N
cowboy	Cowboy	N
nephew	Neffe	N
unicorn	Einhorn	N
fish	Fisch	N
sheep	Schaf	N
island	Insel	N
finger	Finger	N
captain	Kapitän	N
grape	Traube	N
magazine	Magazin	N
totem	Totem	N
locomotive	Lokomotive	N
dude	Kumpel	N
belly	Bauch	N
swimsuit	Badeanzug	N
penguin	Pinguin	N
weather	Wetter	N
mill	Mühle	N
grief	Trauer	N
diet	Diät	N
emotion	Emotion	N
cop	Polizist	N
intelligence	Intelligenz	N
catastrophe	Katastrophe	N
rattlesnake	Klapperschlange	N
date	Datum	N
molecule	Molekül	N
telephone	Telefon	N
jellyfish	Qualle	N
apple	Apfel	N
sticker	Aufkleber	N
rabbit	Kaninchen	N
plane	Ebene	N
comet	Komet	N
banana	Banane	N
light	Licht	N
gin	Gin	N
break	Pause	N
music	Musik	N
painting	Gemälde	N
shepherd	Schäfer	N
clothes	Kleidung	N
author	Autor	N
scratch	Kratzer	N
clock	Uhr	N
graph	Graph	N
hut	Hütte	N
destruction	Zerstörung	N
transition	Übergang	N
sequence	Sequenz	N
bell	Glocke	N
mirror	Spiegel	N
crack	Riss	N
sense	Sinn	N
cage	Käfig	N
snake	Schlange	N
lock	Schloss	N
organ	Orgel	N
bush	Busch	N
instructor	Lehrer	N
newspaper	Zeitung	N
hallway	Flur	N
meat	Fleisch	N
escalator	Rolltreppe	N
graffito	Graffito	N
hero	Held	N
proof	Beweis	N
game	Spiel	N
incident	Vorfall	N
root	Wurzel	N
priest	Priester	N
ethidium	Ethidium	N
place	Platz	N
area	Bereich	N
rust	Rost	N
key	Taste	N
drawer	Schublade	N
ipod	iPod	N
reading	Lesen	N
money	Geld	N
aisle	Gang	N
arch	Bogen	N
map	Karte	N
camp	Lager	N
object	Objekt	N
princess	Prinzessin	N
devil	Teufel	N
jail	Gefängnis	N
companion	Begleiter	N
middle	Mitte	N
bias	Verzerrung	N
sentry	Posten	N
planet	Planet	N
industry	Industrie	N
decoration	Dekoration	N
bat	Schläger	N
gravestone	Grabstein	N
skin	Haut	N
element	Element	N
rabbi	Rabbi	N
nucleus	Kern	N
mob	Mob	N
god	Gott	N
gel	Gel	N
step	Schritt	N
sailor	Seemann	N
device	Gerät	N
style	Stil	N
west	West	N
actor	Darsteller	N
goal	Tor	N
bull	Stier	N
machine	Maschine	N
scientist	Wissenschaftler	N
flood	Flut	N
alcohol	Alkohol	N
fisherman	Fischer	N
turtle	Schildkröte	N
phoenix	Phönix	N
flour	Mehl	N
champion	Champion	N
flame	Flamme	N
peel	Schale	N
fever	Fieber	N
crib	Krippe	N
arrow	Pfeil	N
age	Alter	N
winter	Winter	N
temper	Temperament	N
beauty	Schönheit	N
display	Anzeige	N
sea	Meer	N
anchor	Anker	N
story	Geschichte	N
curve	Kurve	N
sauce	Sauce	N
film	Film	N
soul	Seele	N
mammal	Säugetier	N
morphism	Morphismus	N
depth	Tiefe	N
petal	Blütenblatt	N
jazz	Jazz	N
blackamoor	Blackamoor	N
squirrel	Eichhörnchen	N
quantum	Quant	N
hound	Hund	N
bakery	Bäckerei	N
sunflower	Sonnenblume	N
goo	Schmiere	N
garden	Garten	N
iron	Eisen	N
chopper	Hubschrauber	N
nest	Nest	N
sport	Sport	N
shirt	Hemd	N
bud	Knospe	N
corporation	Gesellschaft	N
river	Fluss	N
poodle	Pudel	N
pizza	Pizza	N
thing	Sache	N
sunlight	Sonnenlicht	N
sunglasses	Sonnenbrille	N
entity	Wesen	N
endurance	Ausdauer	N
cloud	Wolke	N
goose	Gans	N
metro	Metro	N
bucket	Löffel	N
seashore	Strand	N
night	Nacht	N
alley	Gasse	N
asphalt	Asphalt	N
event	Ereignis	N
border	Rand	N
canyon	Schlucht	N
koala	Koala	N
figure	Abbildung	N
snowman	Schneemann	N
pug	Mops	N
wine	Wein	N
fungus	Pilz	N
boundary	Grenze	N
animal	Tier	N
sinner	Sünder	N
caterpillar	Raupe	N
brick	Ziegel	N
hockey	Eishockey	N
hip	Hüfte	N
article	Artikel	N
dirt	Schmutz	N
distraction	Ablenkung	N
basketball	Basketball	N
news	Nachrichten	N
sword	Schwert	N
sickness	Krankheit	N
jar	Glas	N
dolphin	Delphin	N
knight	Ritter	N
calf	Kalb	N
tulip	Tulpe	N
sheriff	Sheriff	N
cookie	Plätzchen	N
mood	Stimmung	N
wool	Wolle	N
toddler	Kleinkind	N
football	Fußball	N
wisdom	Weisheit	N
advertisement	Werbung	N
damsel	Maid	N
door	Tür	N
ghost	Geist	N
lion	Löwe	N
candy	Süßigkeiten	N
punk	Punk	N
mouse	Maus	N
ford	Ford	N
victory	Sieg	N
jaguar	Jaguar	N
order	Reihenfolge	N
slowdown	Verlangsamung	N
partition	Trennwand	N
celebrity	Berühmtheit	N
helium	Helium	N
moment	Moment	N
raspberry	Himbeere	N
theme	Thema	N
hat	Hut	N
course	Kurs	N
flight	Flug	N
cucumber	Gurke	N
skirt	Rock	N
moose	Elch	N
belief	Glauben	N
oil	Öl	N
diffraction	Beugung	N
seat	Sitz	N
ob	ob	N
tear	Riss	N
orb	Gestirn	N
baracudda	Barrakuda	N
witch	Hexe	N
page	Seite	N
region	Region	N
stamp	Stempel	N
ball	Ball	N
house	Haus	N
happiness	Glück	N
bed	Bett	N
topic	Thema	N
cone	Kegel	N
target	Ziel	N
pre	Vor	N
leather	Leder	N
wedding	Hochzeit	N
view	Ansicht	N
college	College	N
sample	Sample	N
landmark	Wahrzeichen	N
tunnel	Tunnel	N
tax	Steuer	N
round	Runde	N
dream	Traum	N
denial	Verweigerung	N
fraud	Betrug	N
brow	Stirn	N
prey	Beute	N
helper	Helfer	N
dinner	Abendessen	N
sidewalk	Gehweg	N
poster	Poster	N
roof	Dach	N
vinegar	Essig	N
table	Tabelle	N
bike	Fahrrad	N
dictionary	Wörterbuch	N
vinyl	Vinyl	N
puppy	Hündchen	N
surf	Brandung	N
can	Dose	N
path	Pfad	N
spoon	Löffel	N
flu	Grippe	N
presence	Gegenwart	N
dessert	Dessert	N
art	Kunst	N
ice	Eis	N
airplane	Flugzeug	N
desert	Wüste	N
chain	Kette	N
interest	Interesse	N
droplet	Tröpfchen	N
magnitude	Größe	N
battery	Batterie	N
zoo	Zoo	N
bus	Bus	N
illusion	Illusion	N
skateboard	Skateboard	N
poppy	Mohn	N
ability	Fähigkeit	N
chocolate	Schokolade	N
second	Sekunde	N
goat	Ziege	N
mermaid	Meerjungfrau	N
shop	Geschäft	N
deck	Deck	N
hostility	Feindseligkeit	N
sushi	Sushi	N
castle	Schloss	N
king	König	N
man	Mann	N
canal	Kanal	N
cigar	Zigarre	N
lung	Lunge	N
vehicle	Fahrzeug	N
opinion	Meinung	N
statue	Statue	N
smoking	Rauchen	N
mosque	Moschee	N
hair	Haar	N
side	Seite	N
window	Fenster	N
mouth	Mund	N
diamond	Diamant	N
ox	Ochse	N
pattern	Muster	N
chair	Stuhl	N
dandelion	Löwenzahn	N
vision	Vision	N
polyester	Polyester	N
eye	Auge	N
wife	Frau	N
misery	Elend	N
pub	Kneipe	N
bloom	Blüte	N
gull	Möwe	N
kitty	Kätzchen	N
definition	Definition	N
chipmunk	Backenhörnchen	N
top	Top	N
pilot	Pilot	N
suds	Schaum	N
cell	Zelle	N
tombstone	Grabstein	N
person	Person	N
jacket	Jacke	N
shadow	Schatten	N
monkey	Affe	N
attention	Aufmerksamkeit	N
ledge	Leiste	N
panda	Panda	N
pollution	Verschmutzung	N
ladder	Leiter	N
city	Stadt	N
cheese	Käse	N
photographer	Fotograf	N
chief	Chef	N
pumpkin	Kürbis	N
sandwich	Sandwich	N
doctor	Arzt	N
impression	Eindruck	N
non	nicht	N
employee	Mitarbeiter	N
chapel	Kapelle	N
linen	Leinen	N
boy	Junge	N
casino	Kasino	N
actress	Darstellerin	N
wound	Wunde	N
stuff	Sachen	N
beetle	Käfer	N
cafe	Cafe	N
pot	Pot	N
burial	Beerdigung	N
foot	Fuß	N
cannon	Kanone	N
criticism	Kritik	N
product	Produkt	N
corridor	Korridor	N
sun	Sonne	N
pair	Paar	N
composer	Komponist	N
marble	Marmor	N
noodle	Nudel	N
circumstance	Umstand	N
character	Charakter	N
color	Farbe	N
fur	Pelz	N
monument	Monument	N
inn	Gasthof	N
charcoal	Holzkohle	N
lamp	Lampe	N
TV	Fernseher	N
camera	Kamera	N
self	Ich	N
library	Bibliothek	N
interior	Innere	N
diner	Gast	N
bird	Vogel	N
texture	Textur	N
triumph	Triumph	N
pride	Stolz	N
slide	Dia	N
horizon	Horizont	N
egg	Ei	N
bishop	Bischof	N
craft	Handwerk	N
nose	Nase	N
stomach	Magen	N
attorney	Rechtsanwalt	N
phenomenon	Phänomen	N
mug	Becher	N
grade	Grad	N
frame	Rahmen	N
passion	Leidenschaft	N
concept	Konzept	N
elephant	Elefant	N
heroine	Heldin	N
owl	Eule	N
nation	Nation	N
storm	Sturm	N
number	Anzahl	N
bikini	Bikini	N
leader	Leader	N
poverty	Armut	N
tile	Fliese	N
friend	Freund	N
car	Auto	N
creator	Urheber	N
cord	Kabel	N
choir	Chor	N
motorcycle	Motorrad	N
log	Log	N
beef	Rindfleisch	N
guardian	Wächter	N
spirit	Geist	N
collection	Sammlung	N
colour	Farbe	N
supper	Abendessen	N
guy	Kerl	N
woman	Frau	N
intuition	Intuition	N
lake	See	N
fountain	Brunnen	N
flag	Flagge	N
celebration	Feier	N
ballad	Ballade	N
pier	Pier	N
vine	Rebe	N
line	Linie	N
evening	Abend	N
surfer	Surfer	N
atmosphere	Atmosphäre	N
bulb	Birne	N
shoulder	Schulter	N
rice	Reis	N
population	Bevölkerung	N
rally	Rallye	N
steak	Steak	N
murder	Mord	N
brain	Gehirn	N
aggression	Aggression	N
cross-section	Durchschnitt	N
lizard	Eidechse	N
shame	Schande	N
costume	Kostüm	N
mask	Maske	N
hamburger	Hamburger	N
com	com	N
aunt	Tante	N
swimming	Schwimmen	N
attitude	Haltung	N
peace	Frieden	N
knee	Knie	N
skeleton	Skeleton	N
legion	Legion	N
aquarium	Aquarium	N
cow	Kuh	N
soup	Suppe	N
rectangle	Rechteck	N
restaurant	Restaurant	N
daughter	Tochter	N
election	Wahl	N
absence	Abwesenheit	N
meteor	Meteor	N
iceberg	Eisberg	N
tumor	Tumor	N
job	Job	N
kite	Drachen	N
printer	Drucker	N
handwriting	Handschrift	N
match	Spiel	N
factory	Fabrik	N
coffee	Kaffee	N
anatomy	Anatomie	N
cherry	Kirsche	N
meal	Mahlzeit	N
cloth	Tuch	N
dentist	Zahnarzt	N
farm	Bauernhof	N
equation	Gleichung	N
sky	Himmel	N
dawn	Dämmerung	N
berry	Beere	N
fury	Wut	N
science	Wissenschaft	N
dad	Vati	N
pepper	Pfeffer	N
state	Zustand	N
dinosaur	Dinosaurier	N
melody	Melodie	N
chicken	Huhn	N
lawyer	Rechtsanwalt	N
assignment	Zuordnung	N
coast	Küste	N
van	Transporter	N
teacher	Lehrer	N
glove	Handschuh	N
ceremony	Zeremonie	N
hummingbird	Kolibri	N
picture	Bild	N
spider	Spinne	N
management	Management	N
stadium	Stadion	N
prisoner	Gefangene	N
fruit	Obst	N
pelican	Pelikan	N
teeth	Gebiss	N
men	Mannschaften	N
career	Karriere	N
capital	Hauptstadt	N
ruin	Ruine	N
bench	Bank	N
journal	Zeitschrift	N
aircraft	Flugzeug	N
business	Unternehmen	N
parrot	Papagei	N
pitcher	Krug	N
wire	Draht	N
racing	Rennen	N
country	Land	N
interval	Intervall	N
image	Image	N
fiend	Teufel	N
groom	Bräutigam	N
south	Süden	N
sorrow	Trauer	N
foliage	Laub	N
uncle	Onkel	N
song	Song	N
continent	Kontinent	N
metal	Metall	N
band	Band	N
stream	Strom	N
language	Sprache	N
goddess	Göttin	N
grass	Gras	N
feather	Feder	N
anarchy	Anarchie	N
tattoo	Tätowierung	N
dog	Hund	N
signature	Unterschrift	N
couple	Paar	N
snow	Schnee	N
motel	Motel	N
palm	Palme	N
carnival	Karneval	N
port	Port	N
bottle	Flasche	N
chest	Brust	N
sketch	Skizze	N
fun	Spaß	N
design	Design	N
nun	Nonne	N
fraternity	Brüderlichkeit	N
sportsman	Sportler	N
community	Gemeinschaft	N
dance	Tanz	N
task	Aufgabe	N
smile	Lächeln	N
apartment	Wohnung	N
letter	Brief	N
maple	Ahorn	N
elbow	Ellbogen	N
officer	Offizier	N
shark	Hai	N
bread	Brot	N
shopping	Einkaufen	N
architecture	Architektur	N
life	Leben	N
blossom	Blüte	N
gravesite	Grabstätte	N
face	Gesicht	N
crow	Krähe	N
sofa	Sofa	N
photo	Foto	N
stencil	Schablone	N
protest	Protest	N
cattle	Rinder	N
blanket	Decke	N
orchid	Orchidee	N
swing	Swing	N
wasp	Wespe	N
water	Wasser	N
ceiling	Decke	N
jet	Jet	N
mare	Stute	N
teenager	Teenager	N
mustard	Senf	N
exit	Ausfahrt	N
beast	Tier	N
pseudo-scorpion	Pseudo-Skorpion	N
hill	Hügel	N
lawn	Rasen	N
hospital	Krankenhaus	N
motor	Motor	N
partner	Partner	N
kiss	Kuss	N
movie	Film	N
kitten	Kätzchen	N
store	Speicher	N
hysteria	Hysterie	N
amphibian	Amphibie	N
desk	Schreibtisch	N
throat	Kehle	N
liver	Leber	N
doll	Puppe	N
librarian	Bibliothekar	N
lego	Lego	N
mannequin	Mannequin	N
seal	Dichtung	N
memorial	Denkmal	N
menu	Menü	N
tragedy	Tragödie	N
skyline	Horizont	N
salt	Salz	N
leg	Bein	N
race	Rennen	N
tail	Schwanz	N
yard	Yard	N
ankle	Knöchel	N
plenty	Menge	N
noise	Lärm	N
deer	Hirsch	N
sphere	Kugel	N
danger	Gefahr	N
grid	Gitter	N
shell	Schale	N
terrier	Terrier	N
body	Körper	N
tower	Turm	N
deity	Gottheit	N
sailing	Segeln	N
surgery	Chirurgie	N
stag	Hirsch	N
cigarette	Zigarette	N
rock	Rock	N
week	Woche	N
auto	Auto	N
guest	Gast	N
winner	Gewinner	N
cemetery	Friedhof	N
field	Feld	N
lens	Linse	N
lamb	Lamm	N
violet	Violett	N
carrot	Karotte	N
seagull	Möwe	N
society	Gesellschaft	N
milk	Milch	N
shore	Ufer	N
indent	Einzug	N
chaos	Chaos	N
tea	Tee	N
ripple	Plätschern	N
piano	Klavier	N
organization	Organisation	N
illness	Krankheit	N
rat	Ratte	N
nail	Nagel	N
pole	Pol	N
tv	Fernseher	N
pod	Hülse	N
cheerleader	Cheerleader	N
room	Zimmer	N
sin	Sünde	N
eagle	Eagle	N
trial	Versuch	N
lady	Dame	N
mist	Nebel	N
difficulty	Schwierigkeit	N
hawk	Falke	N
wave	Welle	N
butter	Butter	N
wealth	Reichtum	N
necklace	Halskette	N
soldier	Soldat	N
purse	Geldbörse	N
wagon	Wagon	N
fraser	Fraser	N
sunset	Sonnenuntergang	N
festival	Festival	N
cellar	Keller	N
inch	Zoll	N
musician	Musiker	N
sweater	Pullover	N
biology	Biologie	N
weekend	Wochenende	N
quest	Suche	N
army	Armee	N
tram	Tram	N
valentine	Valentinskarte	N
orchestra	Orchester	N
competence	Kompetenz	N
slice	Scheibe	N
palace	Palast	N
santa	Weihnachtsmann	N
stocking	Strumpf	N
abundance	Fülle	N
sock	Socke	N
defect	Defekt	N
administration	Verwaltung	N
skill	Fähigkeit	N
stork	Storch	N
tomato	Tomate	N
edge	Rand	N
drizzle	Nieselregen	N
blade	Klinge	N
bridge	Brücke	N
bug	Fehler	N
demolition	Abriss	N
bicycle	Fahrrad	N
monk	Mönch	N
umbrella	Regenschirm	N
clown	Clown	N
folder	Mappe	N
rebel	Rebell	N
taxi	Taxi	N
sign	Zeichen	N
bottom	Boden	N
dollar	Dollar	N
worker	Arbeitnehmer	N
safety	Sicherheit	N
writer	Schriftsteller	N
maker	Hersteller	N
ivy	Efeu	N
giraffe	Giraffe	N
robot	Roboter	N
mayor	Bürgermeister	N
temple	Tempel	N
puppet	Marionette	N
male	Mann	N
chemistry	Chemie	N
mom	Mama	N
artist	Künstler	N
ray	Strahl	N
ant	Ameise	N
exhibition	Ausstellung	N
pregnancy	Schwangerschaft	N
fee	Gebühr	N
communication	Kommunikation	N
patio	Patio	N
ocean	Ozean	N
quilt	Decke	N
limousine	Limousine	N
dress	Kleid	N
orthodontist	Kieferorthopäde	N
pillow	Kissen	N
stud	Zucht	N
corner	Ecke	N
fact	Tatsache	N
panorama	Panorama	N
cancer	Krebs	N
bee	Biene	N
particle	Teilchen	N
brother	Bruder	N
photograph	Foto	N
makeup	Make-up	N
bunny	Hase	N
faun	Faun	N
dew	Tau	N
school	Schule	N
badge	Abzeichen	N
parking	Parken	N
paw	Pfote	N
destination	Reiseziel	N
bride	Braut	N
skull	Schädel	N
cheetah	Gepard	N
lab	Labor	N
wing	Flügel	N
plump	rundlich	N
paper	Papier	N
vacation	Urlaub	N
cream	Creme	N
heart	Herz	N
strength	Stärke	N
cathedral	Kathedrale	N
joy	Freude	N
segment	Segment	N
love	Liebe	N
collar	Kragen	N
drug	Droge	N
crucifix	Kruzifix	N
toilet	Toilette	N
wizard	Zauberer	N
knife	Messer	N
chick	Küken	N
sub	U-Boot	N
teddy	Teddybär	N
market	Markt	N
phrase	Phrase	N
reader	Leser	N
colonel	Oberst	N
boxer	Boxer	N
scream	Schrei	N
navy	Marine	N
fetus	Fötus	N
creature	Kreatur	N
dancer	Tänzer	N
girl	Mädchen	N
nurse	Krankenschwester	N
pool	Pool	N
juice	Saft	N
wheel	Rad	N
lantern	Laterne	N
liquor	Alkohol	N
hamster	Hamster	N
drive	Antrieb	N
furniture	Möbel	N
neck	Hals	N
scooter	Roller	N
rain	Regen	N
sculpture	Skulptur	N
lip	Lippe	N
decade	Dekade	N
backdrop	Hintergrund	N
footprint	Fußabdruck	N
copper	Kupfer	N
astronaut	Astronaut	N
basket	Korb	N
swastika	Hakenkreuz	N
postcard	Postkarte	N
year	Jahr	N
air	Luft	N
maid	Maid	N
bath	Bad	N
tin	Zinn	N
pupil	Schüler	N
bullet	Kugel	N
emergency	Notfall	N
triangle	Dreieck	N
toe	Zehe	N
cooking	Kochen	N
rocket	Rakete	N
club	Verein	N
condition	Zustand	N
cereal	Müsli	N
ink	Tinte	N
barracuda	Barrakuda	N
calendar	Kalender	N
birthday	Geburtstag	N
bomb	Bombe	N
opponent	Gegner	N
orange	Orange	N
august	August	N
gentleman	Gentleman	N
rodent	Nagetier	N
crown	Krone	N
zone	Zone	N
keyboard	Tastatur	N
gate	Tor	N
flamingo	Flamingo	N
street	Straße	N
dragon	Drachen	N
pearl	Perle	N
cabin	Kabine	N
church	Kirche	N
mechanic	Mechaniker	N
disc	Scheibe	N
wood	Holz	N
fire	Feuer	N
payment	Zahlung	N
disease	Krankheit	N
photography	Fotografie	N
windmill	Windmühle	N
garage	Garage	N
party	Party	N
arm	Arm	N
action	Aktion	N
fantasy	Fantasie	N
dusk	Dämmerung	N
awareness	Bewusstsein	N
candidate	Kandidat	N
silhouette	Silhouette	N
phone	Telefon	N
stone	Stein	N
swan	Schwan	N
journey	Reise	N
redhead	Rothaarige	N
agreement	Vereinbarung	N
baseball	Baseball	N
confession	Bekenntnis	N
glass	Glas	N
traffic	Verkehr	N
smiley	Smiley	N
minister	Minister	N
vein	Vene	N
steeple	Kirchturm	N
forest	Wald	N
demon	Dämon	N
brandy	Brandy	N
firework	Feuerwerk	N
time	Zeit	N
rhythm	Rhythmus	N
quote	Zitat	N
volcano	Vulkan	N
lunch	Mittagessen	N
fishing	Angeln	N
marijuana	Marihuana	N
cardboard	Karton	N
book	Buch	N
champagne	Champagner	N
appliance	Gerät	N
passport	Pass	N
gasoline	Benzin	N
police	Polizei	N
world	Welt	N
luck	Glück	N
crowd	Menge	N
bay	Bucht	N
formula	Formel	N
cavern	Höhle	N
ear	Ohr	N
way	Weg	N
paragraph	Absatz	N
driver	Treiber	N
parade	Parade	N
beverage	Getränk	N
loop	Schleife	N
drum	Trommel	N
hand	Hand	N
insect	Insekt	N
culture	Kultur	N
ad	Anzeige	N
coin	Münze	N
document	Dokument	N
theft	Diebstahl	N
kitchen	Küche	N
capability	Fähigkeit	N
container	Container	N
waterfall	Wasserfall	N
aviation	Luftfahrt	N
squad	Kader	N
explosion	Explosion	N
stripe	Streifen	N
rose	Rose	N
cradle	Wiege	N
ship	Schiff	N
home	Haus	N
iris	Iris	N
jewelry	Schmuck	N
minute	Minute	N
bar	Bar	N
elegance	Eleganz	N
button	Taste	N
toy	Spielzeug	N
moss	Moos	N
frost	Frost	N
rope	Seil	N
flesh	Fleisch	N
train	Zug	N
vertex	Scheitel	N
scene	Szene	N
bunch	Bündel	N
illustration	Illustration	N
artwork	Kunstwerk	N
parent	Elternteil	N
pleasure	Vergnügen	N
town	Stadt	N
flower	Blume	N
gut	Darm	N
star	Star	N
hurricane	Hurrikan	N
month	Monat	N
trick	Trick	N
kidney	Niere	N
wall	Wand	N
bracelet	Armband	N
despair	Verzweiflung	N
crime	Kriminalität	N
hotel	Hotel	N
collage	Collage	N
couch	Couch	N
swamp	Sumpf	N
sunrise	Sonnenaufgang	N
instrument	Instrument	N
booth	Stand	N
cliff	Cliff	N
monster	Monster	N
mink	Nerz	N
con	Schwindel	N
symbol	Symbol	N
cent	Cent	N
globe	Globus	N
robbery	Raub	N
point	Punkt	N
peacock	Pfau	N
track	Spur	N
tiger	Tiger	N
gymnastics	Gymnastik	N
section	Abschnitt	N
class	Klasse	N
wrist	Handgelenk	N
aluminum	Aluminium	N
horseman	Reiter	N
reality	Wirklichkeit	N
fashion	Mode	N
son	Sohn	N
mural	Wandgemälde	N
infection	Infektion	N
frog	Frosch	N
mushroom	Pilz	N
beard	Bart	N
plough	Pflug	N
fingerprint	Fingerabdruck	N
tank	Tank	N
bible	Bibel	N
fog	Nebel	N
puddle	Pfütze	N
fox	Fuchs	N
beer	Bier	N
airport	Flughafen	N
pact	Pakt	N
closet	Schrank	N
husband	Mann	N
patient	Patient	N
classroom	Klassenzimmer	N
subway	Untergrundbahn	N
plant	Pflanze	N
curtain	Vorhang	N
boat	Boot	N
scheme	Schema	N
text	Text	N
bathroom	Badezimmer	N
honey	Honig	N
stewardess	Stewardess	N
splash	Spritzen	N
cat	Katze	N
branch	Zweig	N
theory	Theorie	N
park	Park	N
lifetime	Lebensdauer	N
mother	Mutter	N
doorway	Türöffnung	N
homomorphism	Homomorphismus	N
logic	Logik	N
student	Student	N
coat	Mantel	N
neighborhood	Nachbarschaft	N
justice	Gerechtigkeit	N
automobile	Automobil	N
activity	Aktivität	N
north	Norden	N
gold	Gold	N
kangaroo	Känguru	N
haven	Oase	N
exoplanet	Exoplaneten	N
angel	Engel	N
alligator	Alligator	N
portrait	Porträt	N
dye	Farbstoff	N
blood	Blut	N
organisation	Organisation	N
value	Wert	N
billboard	Reklametafel	N
engagement	Engagement	N
economist	Ökonom	N
bowl	Schüssel	N
crane	Kran	N
law	Recht	N
chapter	Kapitel	N
banker	Banker	N
boot	Stiefel	N
archbishop	Erzbischof	N
burger	Hamburger	N
politician	Politiker	N
gorilla	Gorilla	N
oscilloscope	Oszilloskop	N
boardwalk	Holzsteg	N
ignorance	Unwissenheit	N
pencil	Bleistift	N
crochet	häkeln	N
theatre	Theater	N
stitch	Stich	N
confidence	Vertrauen	N
word	Wort	N
atom	Atom	N
sand	Sand	N
pain	Schmerz	N
hymn	Hymne	N
effort	Anstrengung	N
fabric	Stoff	N
prince	Prinz	N
pebble	Kiesel	N
brand	Marke	N
timber	Holz	N
fist	Faust	N
agony	Agonie	N
highway	Autobahn	N
violation	Verstoß	N
candle	Kerze	N
holiday	Urlaub	N
nature	Natur	N
rod	Stange	N
shoe	Schuh	N
conquest	Eroberung	N
doodle	Gekritzel	N
hen	Henne	N
cockatoo	Kakadu	N
elevator	Aufzug	N
beach	Strand	N
jaw	Kiefer	N
adversary	Gegner	N
salary	Gehalt	N
vase	Vase	N
mountain	Berg	N
mallard	Stockente	N
shelter	Schutz	N
reef	Riff	N
truck	LKW	N
fiction	Fiktion	N
strawberry	Erdbeere	N
cup	Tasse	N
pond	Teich	N
secretary	Sekretär	N
might	Macht	N
electron	Elektron	N
node	Knoten	N
father	Vater	N
death	Tod	N
cake	Kuchen	N
manager	Manager	N
daisy	Gänseblümchen	N
kid	Kind	N
cotton	Baumwolle	N
tree	Baum	N
butterfly	Schmetterling	N
turkey	Truthahn	N
sunshine	Sonnenschein	N
marrow	Mark	N
profession	Beruf	N
cross	Kreuz	N
whisker	Whisker	N
size	Größe	N
jump	Sprung	N
mac	Regenmantel	N
reflection	Spiegelung	N
warrior	Krieger	N
code	Code	N
work	Arbeit	N
bead	Korn	N
diver	Taucher	N
president	Präsident	N
box	Box	N
nerve	Nerv	N
century	Jahrhundert	N
computer	Computer	N
ruler	Herrscher	N
hole	Loch	N
literature	Literatur	N
harm	Schaden	N
zebra	Zebra	N
dragonfly	Libelle	N
railroad	Eisenbahn	N
enemy	Feind	N
un	un	N
pipe	Rohr	N
bedroom	Schlafzimmer	N
manner	Weise	N
guitar	Gitarre	N
summer	Sommer	N
institution	Institution	N
professor	Professor	N
fairy	Fee	N
disk	Scheibe	N
appointment	Termin	N
buddy	Kumpel	N
coal	Kohle	N
bean	Bohne	N
salad	Salat	N
museum	Museum	N
wheat	Weizen	N
mud	Schlamm	N
pet	Haustier	N
perception	Wahrnehmung	N
skating	Schlittschuhlaufen	N
child	Kind	N
company	Firma	N
village	Dorf	N
people	Menschen	N
seed	Samen	N
clue	Hinweis	N
travel	Reise	N
transformer	Transformator	N
thumb	Daumen	N
road	Straße	N
twig	Zweig	N
tornado	Tornado	N
helicopter	Hubschrauber	N
horse	Pferd	N
underwear	Unterwäsche	N
brand-new	Brandneu	N
ski	Ski	N
lemon	Zitrone	N
conversation	Gespräch	N
epidemic	Epidemie	N
web	Netz	N
hose	Schlauch	N
sugar	Zucker	N
construction	Bau	N
pie	Torte	N
haze	Dunst	N
waist	Taille	N
threat	Bedrohung	N
leaf	Blatt	N
scenery	Landschaft	N
landscape	Landschaft	N
bubble	Blase	N
income	Einkommen	N
pigeon	Taube	N
gauge	Spur	N
circle	Kreis	N
trip	Reise	N
gossip	Klatsch	N
oak	Eiche	N
vessel	Schiff	N
graveyard	Friedhof	N
battle	Schlacht	N
argument	Argument	N
staircase	Treppe	N
arithmetic	Arithmetik	N
situation	Situation	N
steel	Stahl	N
herb	Kraut	N
show	Show	N
family	Familie	N
era	Epoche	N
wig	Perücke	N
bag	Tasche	N
queen	Königin	N
moon	Mond	N
abdomen	Abdomen	N
skyscraper	Wolkenkratzer	N
wolf	Wolf	N
CD	CD	N
dome	Kuppel	N
chess	Schach	N
logo	Logo	N
lingerie	Unterwäsche	N
par	Par	N
album	Album	N
athlete	Athlet	N
bone	Knochen	N
accident	Unfall	N
balloon	Ballon	N
breakfast	Frühstück	N
ticket	Ticket	N
cocktail	Cocktail	N
fame	Ruhm	N
confusion	Verwirrung	N
verdict	Urteil	N
cousin	Cousin	N
note	Anmerkung	N
angle	Winkel	N
season	Saison	N
harbor	Hafen	N
padlock	Vorhängeschloss	N
limb	Glied	N
valley	Tal	N
right	Recht	N
envelope	Umschlag	N
garbage	Müll	N
pyramid	Pyramide	N
information	Informationen	N
silver	Silber	N
item	Artikel	N
infant	Säugling	N
food	Essen	N
autumn	Herbst	N
nut	Nuss	N
engine	Motor	N
lily	Lilie	N
medium	Medium	N
tooth	Zahn	N
morning	Morgen	N
smoke	Rauch	N
concert	Konzert	N
jean	Jean	N
movement	Bewegung	N
stair	Stufe	N
muscle	Muskel	N
economy	Wirtschaft	N
husky	Schlittenhund	N
biography	Biographie	N
television	Fernsehen	N
cactus	Kaktus	N
whale	Wal	N
tag	Etikett	N
carpet	Teppich	N
pig	Schwein	N
potato	Kartoffel	N
neon	Neon	N
fence	Zaun	N
spring	Feder	N
railway	Eisenbahn	N
horn	Horn	N
wind	Wind	N
bacon	Speck	N
cab	Taxi	N
baby	Baby	N
building	Gebäude	N
day	Tag	N
cheek	Wange	N
model	Modell	N
grave	Grab	N
anger	Zorn	N
rail	Schiene	N
corpse	Leiche	N
racket	Schläger	N
violin	Violine	N
carbon	Kohlenstoff	N
victor	Sieger	N
meter	Meter	N
spine	Rücken	N
comfort	Komfort	N
barn	Scheune	N
adult	Erwachsene	N
straw	Stroh	N
donkey	Esel	N
spiral	Spirale	N
frustration	Frustration	N
station	Station	N
galaxy	Galaxis	N
serpent	Schlange	N
christmas	Weihnachten	N
camel	Kamel	N
vitamin	Vitamin	N
head	Kopf	N
cottage	Hütte	N
skate	Rochen	N
origami	Origami	N
cobra	Kobra	N
idea	Idee	N
reptile	Reptil	N
harbour	Hafen	N
card	Karte	N
donut	Krapfen	N
outfit	Ausrüstung	N
rattle	Rassel	N
saint	Heilige	N
weed	Unkraut	N
psychology	Psychologie	N
hall	Halle	N
carriage	Wagen	N
office	Büro	N
crystal	Kristall	N
surface	Oberfläche	N
employer	Arbeitgeber	N
shade	Schatten	N
crab	Krabbe	N
tobacco	Tabak	N
zombie	Zombie	N
physician	Arzt	N
floor	Boden	N
haircut	Haarschnitt	N
singer	Sänger	N
clip	Klammer	N
plate	Platte	N
freeway	Autobahn	N
cutie	Süße	N
gun	Gewehr	N
drop	fallen	V
protect	schützen	V
understand	verstehen	V
enter	eingeben	V
possess	besitzen	V
predict	vorhersagen	V
play	spielen	V
spend	verbringen	V
replace	ersetzen	V
deny	verweigern	V
choke	ersticken	V
fail	scheitern	V
drip	tropfen	V
deliver	liefern	V
expand	erweitern	V
read	lesen	V
accomplish	erreichen	V
obey	gehorchen	V
comprehend	begreifen	V
portray	porträtieren	V
realize	realisieren	V
sink	sinken	V
inquire	erkundigen	V
leave	verlassen	V
shrink	schrumpfen	V
get	erhalten	V
keep	halten	V
investigate	untersuchen	V
sign	unterzeichnen	V
cherish	hegen	V
build	bauen	V
appoint	ernennen	V
carry	tragen	V
save	speichern	V
elect	wählen	V
examine	prüfen	V
fall	fallen	V
hang	aufhängen	V
hear	hören	V
feel	fühlen	V
disorganize	durcheinander bringen	V
pursue	verfolgen	V
shed	vergießen	V
restore	wiederherstellen	V
enjoy	genießen	V
argue	argumentieren	V
acquire	erwerben	V
justify	rechtfertigen	V
do	tun	V
write	schreiben	V
achieve	erreichen	V
behave	sich benehmen	V
seem	scheinen	V
forget	vergessen	V
conclude	abschließen	V
walk	gehen	V
satisfy	erfüllen	V
paint	malen	V
go	gehen	V
plead	plädieren	V
inform	informieren	V
buy	kaufen	V
sleep	schlafen	V
meet	treffen	V
forgive	verzeihen	V
please	gefallen	V
disappear	verschwinden	V
participate	teilnehmen	V
swim	schwimmen	V
become	werden	V
absorb	absorbieren	V
steal	stehlen	V
add	hinzufügen	V
remind	erinnern	V
prove	beweisen	V
glitter	funkeln	V
appear	erscheinen	V
find	finden	V
take	nehmen	V
ask	fragen	V
marry	heiraten	V
reduce	reduzieren	V
sit	sitzen	V
beg	bitten	V
wash	waschen	V
explain	erklären	V
contemplate	betrachten	V
wander	wandern	V
allow	zulassen	V
pray	beten	V
attend	besuchen	V
verify	überprüfen	V
determine	bestimmen	V
grow	wachsen	V
succeed	gelingen	V
kill	töten	V
remain	bleiben	V
blur	verwischen	V
imitate	imitieren	V
lose	verlieren	V
roam	wandern	V
multiply	multiplizieren	V
learn	lernen	V
lock	sperren	V
compare	vergleichen	V
eat	essen	V
borrow	leihen	V
occur	auftreten	V
try	versuchen	V
join	beitreten	V
vanish	verschwinden	V
deserve	verdienen	V
assume	übernehmen	V
put	setzen	V
recommend	empfehlen	V
discover	entdecken	V
run	laufen	V
think	denken	V
create	schaffen	V
proclaim	verkünden	V
come	kommen	V
encourage	fördern	V
live	leben	V
agree	zustimmen	V
speak	sprechen	V
differ	abweichen	V
locate	lokalisieren	V
engage	engagieren	V
want	wollen	V
communicate	kommunizieren	V
ignore	ignorieren	V
accept	akzeptieren	V
quit	verlassen	V
discourage	entmutigen	V
declare	erklären	V
evaluate	bewerten	V
dominate	dominieren	V
win	gewinnen	V
advise	beraten	V
withdraw	zurückziehen	V
make	machen	V
give	geben	V
divide	teilen	V
overcome	überwinden	V
analyze	analysieren	V
imagine	annehmen	V
require	erfordern	V
discuss	diskutieren	V
inspect	überprüfen	V
acknowledge	bestätigen	V
obtain	erhalten	V
stand	stehen	V
cooperate	zusammenarbeiten	V
hold	halten	V
destroy	zerstören	V
handle	behandeln	V
begin	beginnen	V
abandon	verlassen	V
earn	verdienen	V
greet	begrüßen	V
complain	beschweren	V
listen	hören	V
rationalize	rationalisieren	V
avoid	vermeiden	V
originate	entstehen	V
receive	erhalten	V
pretend	vorgeben	V
explore	erkunden	V
sell	verkaufen	V
stop	stoppen	V
reject	ablehnen	V
relax	entspannen	V
persuade	überzeugen	V
lick	lecken	V
bring	bringen	V
sing	singen	V
fly	fliegen	V
retain	behalten	V
arrive	ankommen	V
say	sagen	V
organize	organisieren	V
choose	wählen	V
lend	verleihen	V
breathe	atmen	V
entertain	unterhalten	V
burn	brennen	V
knit	stricken	V
draw	ziehen	V
clarify	klären	V
post	buchen	V
owe	verdanken	V
attach	befestigen	V
know	wissen	V
arrange	arrangieren	V
bear	tragen	V
curl	locken	V
decide	entscheiden	V
happen	geschehen	V
construct	konstruieren	V
notify	benachrichtigen	V
believe	glauben	V
defend	verteidigen	V
gather	sammeln	V
announce	anmelden	V
send	senden	V
collect	sammeln	V
