unnecessary	inutile	A
insane	folle	A
dirty	sporco	A
obvious	evidente	A
scarce	scarso	A
vintage	d'annata	A
rapid	rapido	A
ashamed	vergognoso	A
orange	arancione	A
happy	felice	A
black	nero	A
normal	normale	A
pink	rosa	A
graphic	grafico	A
hot	caldo	A
important	importante	A
friendly	amichevole	A
dead	morto	A
bad	cattivo	A
outdoor	esterno	A
narrow	stretto	A
crazy	pazzo	A
dreary	triste	A
great	grande	A
anxious	ansioso	A
abstract	astratto	A
cruel	crudele	A
difficult	difficile	A
clever	intelligente	A
tall	alto	A
broad	ampio	A
female	femminile	A
tropical	tropicale	A
different	diverso	A
foolish	sciocco	A
underwater	subacqueo	A
sunny	soleggiato	A
glad	felice	A
simple	semplice	A
bold	audace	A
sharp	tagliente	A
sure	sicuro	A
restless	inquieto	A
blue	blu	A
intelligent	intelligente	A
brown	marrone	A
mad	pazzo	A
smart	intelligente	A
exotic	esotico	A
key	importante	A
cute	carino	A
military	militare	A
frigid	glaciale	A
large	grande	A
white	bianco	A
nice	bello	A
dull	opaco	A
yellow	giallo	A
old	vecchio	A
underground	sotterraneo	A
dumb	muto	A
funny	divertente	A
sweet	dolce	A
sexy	sexy	A
wet	bagnato	A
industrial	industriale	A
fast	veloce	A
afraid	impaurito	A
rough	ruvido	A
feline	felino	A
sly	sornione	A
wild	selvaggio	A
laden	gravido	A
modest	modesto	A
ancient	antico	A
tough	difficile	A
illegal	illegale	A
easy	facile	A
immoral	immorale	A
urban	urbano	A
wonderful	meraviglioso	A
young	giovane	A
cheerful	allegro	A
strong	forte	A
beautiful	bello	A
crucial	cruciale	A
unhappy	infelice	A
proud	orgoglioso	A
dense	denso	A
weird	strano	A
wide	ampio	A
blonde	biondo	A
fragile	fragile	A
pregnant	incinta	A
uniform	uniforme	A
quick	veloce	A
bright	luminoso	A
violent	violento	A
terrible	terribile	A
recent	recente	A
essential	essenziale	A
canine	canino	A
honest	onesto	A
rare	raro	A
stupid	stupido	A
sick	malato	A
square	quadrato	A
flexible	flessibile	A
inexpensive	poco costoso	A
modern	moderno	A
childish	infantile	A
harsh	duro	A
heavy	pesante	A
misty	nebbioso	A
grey	grigio	A
proper	corretto	A
nude	nudo	A
tiny	piccolo	A
cold	freddo	A
necessary	necessario	A
confident	fiducioso	A
colorful	colorato	A
red	rosso	A
odd	dispari	A
cheap	conveniente	A
short	breve	A
small	piccolo	A
hard	difficile	A
certain	certo	A
strange	strano	A
fresh	fresco	A
concrete	concreto	A
new	nuovo	A
guilty	colpevole	A
noticeable	evidente	A
long	lungo	A
green	verde	A
angry	arrabbiato	A
polite	gentile	A
sad	triste	A
impatient	impaziente	A
frozen	congelato	A
formal	formale	A
bizarre	bizzarro	A
generous	generoso	A
big	grande	A
rusty	arrugginito	A
huge	enorme	A
purple	purpureo	A
dark	scuro	A
aerial	aereo	A
awful	terribile	A
terrific	eccezionale	A
downtown	centro	A
miniature	in miniatura	A
apparent	apparente	A
ceramic	ceramica	A
delightful	delizioso	A
elastic	elastico	A
lighthouse	faro	N
universe	universo	N
whiskey	whisky	N
essay	prova	N
belt	cintura	N
university	università	N
colt	puledro	N
pantyhose	collant	N
commonwealth	repubblica	N
lighting	illuminazione	N
cube	cubo	N
duck	anatra	N
pin	perno	N
insight	intuito	N
discussion	discussione	N
rainbow	arcobaleno	N
prestige	prestigio	N
trail	sentiero	N
daffodil	giunchiglia	N
tongue	lingua	N
porch	veranda	N
choice	scelta	N
lover	amante	N
cowboy	buttero	N
nephew	nipote	N
unicorn	unicorno	N
fish	pesce	N
sheep	pecora	N
island	isola	N
finger	dito	N
captain	capitano	N
grape	uva	N
magazine	rivista	N
totem	totem	N
locomotive	locomotiva	N
dude	bellimbusto	N
belly	pancia	N
swimsuit	costume da bagno	N
penguin	pinguino	N
weather	tempo	N
mill	mulino	N
grief	dolore	N
diet	dieta	N
emotion	emozione	N
cop	poliziotto	N
intelligence	intelligenza	N
catastrophe	catastrofe	N
rattlesnake	serpente a sonagli	N
date	data	N
molecule	molecola	N
telephone	telefono	N
jellyfish	medusa	N
apple	mela	N
sticker	sticker	N
rabbit	coniglio	N
plane	piano	N
comet	cometa	N
banana	banana	N
light	luce	N
gin	gin	N
break	pausa	N
music	musica	N
painting	dipinto	N
shepherd	pastore	N
clothes	vestiti	N
author	autore	N
scratch	zero	N
clock	orologio	N
graph	grafico	N
hut	capanna	N
destruction	distruzione	N
transition	transizione	N
sequence	sequenza	N
bell	campana	N
mirror	specchio	N
crack	crepa	N
sense	senso	N
cage	gabbia	N
snake	serpente	N
lock	serratura	N
organ	organo	N
bush	cespuglio	N
instructor	istruttore	N
newspaper	giornale	N
hallway	corridoio	N
meat	carne	N
escalator	scala mobile	N
graffito	graffito	N
hero	eroe	N
proof	prova	N
game	gioco	N
incident	incidente	N
root	radice	N
priest	sacerdote	N
ethidium	etidio	N
place	posto	N
area	zona	N
rust	ruggine	N
key	chiave	N
drawer	cassetto	N
ipod	ipod	N
reading	lettura	N
money	soldi	N
aisle	corridoio	N
arch	arco	N
map	mappa	N
camp	campo	N
object	oggetto	N
princess	principessa	N
devil	demone	N
jail	prigione	N
companion	compagno	N
middle	mezzo	N
bias	diagonale	N
sentry	sentinella	N
planet	pianeta	N
industry	industria	N
decoration	decorazione	N
bat	pipistrello	N
gravestone	pietra sepolcrale	N
skin	pelle	N
element	elemento	N
rabbi	rabbino	N
nucleus	nucleo	N
mob	folla	N
god	divinità	N
gel	gel	N
step	passo	N
sailor	marinaio	N
device	dispositivo	N
style	stile	N
west	ovest	N
actor	attore	N
goal	scopo	N
bull	toro	N
machine	macchina	N
scientist	scienziato	N
flood	inondazione	N
alcohol	alcol	N
fisherman	pescatore	N
turtle	tartaruga acquatica	N
phoenix	fenice	N
flour	farina	N
champion	campione	N
flame	fiamma	N
peel	buccia	N
fever	febbre	N
crib	culla	N
arrow	freccia	N
age	età	N
winter	inverno	N
temper	temperamento	N
beauty	bellezza	N
display	display	N
sea	mare	N
anchor	ancora	N
story	storia	N
curve	curva	N
sauce	salsa	N
film	film	N
soul	anima	N
mammal	mammifero	N
morphism	morfismo	N
depth	profondità	N
petal	petalo	N
jazz	jazz	N
blackamoor	negro	N
squirrel	scoiattolo	N
quantum	quanto	N
hound	segugio	N
bakery	forno	N
sunflower	girasole	N
goo	goo	N
garden	giardino	N
iron	ferro	N
chopper	mannaia	N
nest	nido	N
sport	sport	N
shirt	camicia	N
bud	germoglio	N
corporation	società	N
river	fiume	N
poodle	barboncino	N
pizza	pizza	N
thing	cosa	N
sunlight	luce del sole	N
sunglasses	occhiali da sole	N
entity	entità	N
endurance	resistenza	N
cloud	nube	N
goose	oca	N
metro	Metro	N
bucket	benna	N
seashore	riva del mare	N
night	notte	N
alley	vicolo	N
asphalt	asfalto	N
event	evento	N
border	confine	N
canyon	canyon	N
koala	koala	N
figure	figura	N
snowman	pupazzo di neve	N
pug	carlino	N
wine	vino	N
fungus	fungo	N
boundary	confine	N
animal	animale	N
sinner	peccatore	N
caterpillar	bruco	N
brick	mattone	N
hockey	hockey	N
hip	anca	N
article	articolo	N
dirt	sporcizia	N
distraction	distrazione	N
basketball	pallacanestro	N
news	notizie	N
sword	spada	N
sickness	malattia	N
jar	vaso	N
dolphin	delfino	N
knight	cavaliere	N
calf	vitello	N
tulip	tulipano	N
sheriff	sceriffo	N
cookie	biscotto	N
mood	umore	N
wool	lana	N
toddler	bimbo che impara camminare	N
football	calcio	N
wisdom	saggezza	N
advertisement	pubblicità	N
damsel	donzella	N
door	porta	N
ghost	fantasma	N
lion	leone	N
candy	caramella	N
punk	punk	N
mouse	mouse	N
ford	guado	N
victory	vittoria	N
jaguar	giaguaro	N
order	ordine	N
slowdown	rallentamento	N
partition	partizione	N
celebrity	celebrità	N
helium	elio	N
moment	momento	N
raspberry	lampone	N
theme	tema	N
hat	cappello	N
course	corso	N
flight	volo	N
cucumber	cetriolo	N
skirt	gonna	N
moose	alce americano	N
belief	credenza	N
oil	olio	N
diffraction	diffrazione	N
seat	sede	N
ob	ob	N
tear	lacrima	N
orb	globo	N
baracudda	Barracuda	N
witch	strega	N
page	pagina	N
region	regione	N
stamp	timbro	N
ball	palla	N
house	casa	N
happiness	felicità	N
bed	letto	N
topic	argomento	N
cone	cono	N
target	obiettivo	N
pre	pre	N
leather	pelle	N
wedding	matrimonio	N
view	vista	N
college	college	N
sample	campione	N
landmark	punto di riferimento	N
tunnel	tunnel	N
tax	tasse	N
round	turno	N
dream	sogno	N
denial	negazione	N
fraud	frode	N
brow	fronte	N
prey	preda	N
helper	aiutante	N
dinner	cena	N
sidewalk	marciapiede	N
poster	poster	N
roof	tetto	N
vinegar	aceto	N
table	tabella	N
bike	bici	N
dictionary	dizionario	N
vinyl	vinile	N
puppy	cucciolo	N
surf	spuma	N
can	lattina	N
path	sentiero	N
spoon	cucchiaio	N
flu	influenza	N
presence	presenza	N
dessert	dessert	N
art	arte	N
ice	ghiaccio	N
airplane	aereo	N
desert	deserto	N
chain	catena	N
interest	interesse	N
droplet	gocciolina	N
magnitude	grandezza	N
battery	batteria	N
zoo	zoo	N
bus	autobus	N
illusion	illusione	N
skateboard	skateboard	N
poppy	papavero	N
ability	capacità	N
chocolate	cioccolato	N
second	secondo	N
goat	capra	N
mermaid	sirena	N
shop	negozio	N
deck	ponte	N
hostility	ostilità	N
sushi	Sushi	N
castle	castello	N
king	re	N
man	uomo	N
canal	canale	N
cigar	sigaro	N
lung	polmone	N
vehicle	veicolo	N
opinion	opinione	N
statue	statua	N
smoking	fumo	N
mosque	moschea	N
hair	capelli	N
side	lato	N
window	finestra	N
mouth	bocca	N
diamond	diamante	N
ox	bue	N
pattern	modello	N
chair	sedia	N
dandelion	dente di leone	N
vision	visione	N
polyester	poliestere	N
eye	occhio	N
wife	moglie	N
misery	miseria	N
pub	pub	N
bloom	fiore	N
gull	gabbiano	N
kitty	gattino	N
definition	definizione	N
chipmunk	chipmunk	N
top	cima	N
pilot	pilota	N
suds	schiuma	N
cell	cella	N
tombstone	lapide	N
person	persona	N
jacket	giacca	N
shadow	ombra	N
monkey	scimmia	N
attention	attenzione	N
ledge	cornice	N
panda	panda	N
pollution	inquinamento	N
ladder	scala	N
city	città	N
cheese	formaggio	N
photographer	fotografo	N
chief	capo	N
pumpkin	zucca	N
sandwich	panino	N
doctor	medico	N
impression	impressione	N
non	non	N
employee	dipendente	N
chapel	cappella	N
linen	biancheria	N
boy	ragazzo	N
casino	casinò	N
actress	attrice	N
wound	ferita	N
stuff	roba	N
beetle	scarafaggio	N
cafe	caffè	N
pot	pentola	N
burial	sepoltura	N
foot	piede	N
cannon	cannone	N
criticism	critica	N
product	prodotto	N
corridor	corridoio	N
sun	sole	N
pair	coppia	N
composer	compositore	N
marble	marmo	N
noodle	tagliatelle	N
circumstance	circostanza	N
character	carattere	N
color	colore	N
fur	pelliccia	N
monument	monumento	N
inn	locanda	N
charcoal	carbone	N
lamp	lampada	N
TV	tv	N
camera	telecamera	N
self	se stesso	N
library	biblioteca	N
interior	interno	N
diner	commensale	N
bird	uccello	N
texture	struttura	N
triumph	trionfo	N
pride	orgoglio	N
slide	diapositiva	N
horizon	orizzonte	N
egg	uovo	N
bishop	vescovo	N
craft	mestiere	N
nose	naso	N
stomach	stomaco	N
attorney	procuratore	N
phenomenon	fenomeno	N
mug	boccale	N
grade	grado	N
frame	cornice	N
passion	passione	N
concept	concetto	N
elephant	elefante	N
heroine	eroina	N
owl	gufo	N
nation	nazione	N
storm	tempesta	N
number	numero	N
bikini	bikini	N
leader	leader	N
poverty	povertà	N
tile	piastrella	N
friend	amico	N
car	auto	N
creator	fattore	N
cord	cordone	N
choir	coro	N
motorcycle	motociclo	N
log	ceppo	N
beef	manzo	N
guardian	custode	N
spirit	spirito	N
collection	collezione	N
colour	colore	N
supper	cena	N
guy	tipo	N
woman	donna	N
intuition	intuizione	N
lake	lago	N
fountain	fontana	N
flag	bandiera	N
celebration	celebrazione	N
ballad	ballata	N
pier	molo	N
vine	vite	N
line	linea	N
evening	sera	N
surfer	surfer	N
atmosphere	atmosfera	N
bulb	lampadina	N
shoulder	spalla	N
rice	riso	N
population	popolazione	N
rally	rally	N
steak	bistecca	N
murder	omicidio	N
brain	cervello	N
aggression	aggressione	N
cross-section	sezione traversale	N
lizard	lucertola	N
shame	vergogna	N
costume	costume	N
mask	maschera	N
hamburger	hamburger	N
com	com	N
aunt	zia	N
swimming	nuoto	N
attitude	atteggiamento	N
peace	pace	N
knee	ginocchio	N
skeleton	scheletro	N
legion	legione	N
aquarium	acquario	N
cow	mucca	N
soup	zuppa	N
rectangle	rettangolo	N
restaurant	ristorante	N
daughter	figlia	N
election	elezione	N
absence	assenza	N
meteor	meteora	N
iceberg	iceberg	N
tumor	tumore	N
job	lavoro	N
kite	aquilone	N
printer	stampante	N
handwriting	grafia	N
match	partita	N
factory	fabbrica	N
coffee	caffè	N
anatomy	anatomia	N
cherry	ciliegia	N
meal	pasto	N
cloth	panno	N
dentist	dentista	N
farm	fattoria	N
equation	equazione	N
sky	cielo	N
dawn	alba	N
berry	bacca	N
fury	furia	N
science	scienza	N
dad	papà	N
pepper	pepe	N
state	stato	N
dinosaur	dinosauro	N
melody	melodia	N
chicken	pollo	N
lawyer	avvocato	N
assignment	assegnazione	N
coast	costa	N
van	furgone	N
teacher	insegnante	N
glove	guanto	N
ceremony	cerimonia	N
hummingbird	colibrì	N
picture	immagine	N
spider	ragno	N
management	gestione	N
stadium	stadio	N
prisoner	prigioniero	N
fruit	frutta	N
pelican	pellicano	N
teeth	dente	N
men	maschi	N
career	carriera	N
capital	capitale	N
ruin	rovina	N
bench	banco	N
journal	rivista	N
aircraft	aereo	N
business	affari	N
parrot	pappagallo	N
pitcher	brocca	N
wire	filo	N
racing	corsa	N
country	paese	N
interval	intervallo	N
image	immagine	N
fiend	demonio	N
groom	sposo	N
south	sud	N
sorrow	dolore	N
foliage	fogliame	N
uncle	zio	N
song	canzone	N
continent	continente	N
metal	metallo	N
band	banda	N
stream	corrente	N
language	lingua	N
goddess	dea	N
grass	erba	N
feather	piuma	N
anarchy	anarchia	N
tattoo	tatuaggio	N
dog	cane	N
signature	firma	N
couple	coppia	N
snow	neve	N
motel	motel	N
palm	palma	N
carnival	carnevale	N
port	porta	N
bottle	bottiglia	N
chest	petto	N
sketch	schizzo	N
fun	divertimento	N
design	design	N
nun	suora	N
fraternity	fraternità	N
sportsman	sportivo	N
community	comunità	N
dance	danza	N
task	compito	N
smile	sorriso	N
apartment	appartamento	N
letter	lettera	N
maple	acero	N
elbow	gomito	N
officer	ufficiale	N
shark	squalo	N
bread	pane	N
shopping	shopping	N
architecture	architettura	N
life	vita	N
blossom	fiore	N
gravesite	tomba	N
face	faccia	N
crow	corvo	N
sofa	divano	N
photo	foto	N
stencil	stampino	N
protest	protesta	N
cattle	bestiame	N
blanket	coperta	N
orchid	orchidea	N
swing	swing	N
wasp	vespa	N
water	acqua	N
ceiling	soffitto	N
jet	getto	N
mare	cavalla	N
teenager	adolescente	N
mustard	senape	N
exit	uscita	N
beast	bestia	N
pseudo-scorpion	pseudo-scorpione	N
hill	collina	N
lawn	prato	N
hospital	ospedale	N
motor	motore	N
partner	partner	N
kiss	bacio	N
movie	film	N
kitten	gattino	N
store	negozio	N
hysteria	isterismo	N
amphibian	anfibio	N
desk	scrivania	N
throat	gola	N
liver	fegato	N
doll	bambola	N
librarian	bibliotecario	N
lego	Lego	N
mannequin	indossatrice	N
seal	sigillo	N
memorial	memoriale	N
menu	menu	N
tragedy	tragedia	N
skyline	linea dell'orizzonte	N
salt	sale	N
leg	gamba	N
race	gara	N
tail	coda	N
yard	cantiere	N
ankle	caviglia	N
plenty	abbondanza	N
noise	rumore	N
deer	cervo	N
sphere	sfera	N
danger	pericolo	N
grid	griglia	N
shell	guscio	N
terrier	terrier	N
body	corpo	N
tower	torre	N
deity	divinità	N
sailing	vela	N
surgery	chirurgia	N
stag	cervo	N
cigarette	sigaretta	N
rock	rock	N
week	settimana	N
auto	auto	N
guest	ospite	N
winner	vincitore	N
cemetery	cimitero	N
field	campo	N
lens	lente	N
lamb	agnello	N
violet	viola	N
carrot	carota	N
seagull	gabbiano	N
society	società	N
milk	latte	N
shore	riva	N
indent	dentellatura	N
chaos	caos	N
tea	tè	N
ripple	ondulazione	N
piano	pianoforte	N
organization	organizzazione	N
illness	malattia	N
rat	ratto	N
nail	chiodo	N
pole	polo	N
tv	tv	N
pod	baccello	N
cheerleader	cheerleader	N
room	camera	N
sin	peccato	N
eagle	aquila	N
trial	prova	N
lady	signora	N
mist	nebbia	N
difficulty	difficoltà	N
hawk	falco	N
wave	onda	N
butter	burro	N
wealth	ricchezza	N
necklace	collana	N
soldier	soldato	N
purse	borsa	N
wagon	carro	N
fraser	Fraser	N
sunset	tramonto	N
festival	festival	N
cellar	cantina	N
inch	pollice	N
musician	musicista	N
sweater	maglione	N
biology	biologia	N
weekend	weekend	N
quest	ricerca	N
army	esercito	N
tram	tram	N
valentine	innamorato	N
orchestra	orchestra	N
competence	competenza	N
slice	fetta	N
palace	palazzo	N
santa	Santa	N
stocking	calza	N
abundance	abbondanza	N
sock	calzino	N
defect	difetto	N
administration	amministrazione	N
skill	abilità	N
stork	cicogna	N
tomato	pomodoro	N
edge	bordo	N
drizzle	pioggerella	N
blade	lama	N
bridge	ponte	N
bug	errore	N
demolition	demolizione	N
bicycle	bicicletta	N
monk	monaco	N
umbrella	ombrello	N
clown	clown	N
folder	cartella	N
rebel	insorto	N
taxi	taxi	N
sign	segno	N
bottom	fondo	N
dollar	dollaro	N
worker	lavoratore	N
safety	sicurezza	N
writer	scrittore	N
maker	creatore	N
ivy	edera	N
giraffe	giraffa	N
robot	robot	N
mayor	sindaco	N
temple	tempio	N
puppet	fantoccio	N
male	maschio	N
chemistry	chimica	N
mom	mamma	N
artist	artista	N
ray	raggio	N
ant	formica	N
exhibition	mostra	N
pregnancy	gravidanza	N
fee	tassa	N
communication	comunicazione	N
patio	patio	N
ocean	oceano	N
quilt	trapunta	N
limousine	limousine	N
dress	vestito	N
orthodontist	ortodontista	N
pillow	cuscino	N
stud	perno	N
corner	angolo	N
fact	fatto	N
panorama	panorama	N
cancer	cancro	N
bee	ape	N
particle	particella	N
brother	fratello	N
photograph	fotografia	N
makeup	trucco	N
bunny	coniglietto	N
faun	fauno	N
dew	rugiada	N
school	scuola	N
badge	distintivo	N
parking	parcheggio	N
paw	zampa	N
destination	destinazione	N
bride	sposa	N
skull	cranio	N
cheetah	ghepardo	N
lab	laboratorio	N
wing	ala	N
plump	paffuto	N
paper	carta	N
vacation	vacanza	N
cream	crema	N
heart	cuore	N
strength	forza	N
cathedral	cattedrale	N
joy	gioia	N
segment	segmento	N
love	amore	N
collar	collare	N
drug	farmaco	N
crucifix	crocifisso	N
toilet	toilette	N
wizard	mago	N
knife	coltello	N
chick	pulcino	N
sub	sub	N
teddy	orsacchiotto	N
market	mercato	N
phrase	frase	N
reader	lettore	N
colonel	colonnello	N
boxer	pugile	N
scream	urlo	N
navy	marina	N
fetus	feto	N
creature	creatura	N
dancer	ballerino	N
girl	ragazza	N
nurse	infermiera	N
pool	piscina	N
juice	succo	N
wheel	ruota	N
lantern	lanterna	N
liquor	liquore	N
hamster	criceto	N
drive	guida	N
furniture	arredamento	N
neck	collo	N
scooter	scooter	N
rain	pioggia	N
sculpture	scultura	N
lip	labbro	N
decade	decennio	N
backdrop	fondale	N
footprint	orma	N
copper	rame	N
astronaut	astronauta	N
basket	cestino	N
swastika	svastica	N
postcard	cartolina	N
year	anno	N
air	aria	N
maid	cameriera	N
bath	bagno	N
tin	stagno	N
pupil	pupilla	N
bullet	proiettile	N
emergency	emergenza	N
triangle	triangolo	N
toe	punta	N
cooking	cucina	N
rocket	razzo	N
club	club	N
condition	condizione	N
cereal	cereale	N
ink	inchiostro	N
barracuda	Barracuda	N
calendar	calendario	N
birthday	compleanno	N
bomb	bomba	N
opponent	avversario	N
orange	arancione	N
august	augusto	N
gentleman	signore	N
rodent	roditore	N
crown	corona	N
zone	zona	N
keyboard	tastiera	N
gate	cancello	N
flamingo	fenicottero	N
street	strada	N
dragon	drago	N
pearl	perla	N
cabin	cabina	N
church	chiesa	N
mechanic	meccanico	N
disc	disco	N
wood	legno	N
fire	fuoco	N
payment	pagamento	N
disease	malattia	N
photography	fotografia	N
windmill	mulino a vento	N
garage	garage	N
party	festa	N
arm	braccio	N
action	azione	N
fantasy	fantasia	N
dusk	crepuscolo	N
awareness	consapevolezza	N
candidate	candidato	N
silhouette	silhouette	N
phone	telefono	N
stone	pietra	N
swan	cigno	N
journey	viaggio	N
redhead	rosso	N
agreement	accordo	N
baseball	baseball	N
confession	confessione	N
glass	vetro	N
traffic	traffico	N
smiley	smiley	N
minister	ministro	N
vein	vena	N
steeple	campanile	N
forest	foresta	N
demon	demone	N
brandy	brandy	N
firework	fuoco d'artificio	N
time	tempo	N
rhythm	ritmo	N
quote	citazione	N
volcano	vulcano	N
lunch	pranzo	N
fishing	pesca	N
marijuana	marijuana	N
cardboard	cartone	N
book	libro	N
champagne	champagne	N
appliance	apparecchio	N
passport	passaporto	N
gasoline	benzina	N
police	polizia	N
world	mondo	N
luck	fortuna	N
crowd	folla	N
bay	baia	N
formula	formula	N
cavern	caverna	N
ear	orecchio	N
way	modo	N
paragraph	paragrafo	N
driver	autista	N
parade	parata	N
beverage	bevanda	N
loop	anello	N
drum	tamburo	N
hand	mano	N
insect	insetto	N
culture	cultura	N
ad	annuncio	N
coin	moneta	N
document	documento	N
theft	furto	N
kitchen	cucina	N
capability	capacità	N
container	contenitore	N
waterfall	cascata	N
aviation	aviazione	N
squad	squadra	N
explosion	esplosione	N
stripe	banda	N
rose	bulbo forato	N
cradle	culla	N
ship	nave	N
home	casa	N
iris	iris	N
jewelry	gioielli	N
minute	minuto	N
bar	bar	N
elegance	eleganza	N
button	pulsante	N
toy	giocattolo	N
moss	muschio	N
frost	gelo	N
rope	corda	N
flesh	carne	N
train	treno	N
vertex	vertice	N
scene	scena	N
bunch	mazzo	N
illustration	illustrazione	N
artwork	opera d'arte	N
parent	genitore	N
pleasure	diporto	N
town	città	N
flower	fiore	N
gut	budello	N
star	stella	N
hurricane	uragano	N
month	mese	N
trick	trucco	N
kidney	rene	N
wall	parete	N
bracelet	braccialetto	N
despair	disperazione	N
crime	crimine	N
hotel	albergo	N
collage	collage	N
couch	divano	N
swamp	palude	N
sunrise	alba	N
instrument	strumento	N
booth	cabina	N
cliff	scogliera	N
monster	mostro	N
mink	visone	N
con	contro	N
symbol	simbolo	N
cent	centesimo di dollaro	N
globe	globo	N
robbery	rapina	N
point	punto	N
peacock	pavone	N
track	traccia	N
tiger	tigre	N
gymnastics	ginnastica	N
section	sezione	N
class	classe	N
wrist	polso	N
aluminum	alluminio	N
horseman	cavaliere	N
reality	realtà	N
fashion	moda	N
son	figlio	N
mural	murale	N
infection	infezione	N
frog	rana	N
mushroom	fungo	N
beard	barba	N
plough	aratro	N
fingerprint	impronta	N
tank	serbatoio	N
bible	Bibbia	N
fog	nebbia	N
puddle	pozzanghera	N
fox	volpe	N
beer	birra	N
airport	aeroporto	N
pact	patto	N
closet	armadio	N
husband	marito	N
patient	paziente	N
classroom	aula	N
subway	metropolitana	N
plant	pianta	N
curtain	tenda	N
boat	barca	N
scheme	schema	N
text	testo	N
bathroom	bagno	N
honey	miele	N
stewardess	hostess	N
splash	spruzzo	N
cat	gatto	N
branch	ramo	N
theory	teoria	N
park	parco	N
lifetime	tutta la vita	N
mother	madre	N
doorway	portone	N
homomorphism	homomorphism	N
logic	logica	N
student	studente	N
coat	cappotto	N
neighborhood	quartiere	N
justice	giustizia	N
automobile	automobile	N
activity	attività	N
north	nord	N
gold	oro	N
kangaroo	canguro	N
haven	rifugio	N
exoplanet	esopianeta	N
angel	angelo	N
alligator	alligatore	N
portrait	ritratto	N
dye	colorante	N
blood	sangue	N
organisation	organizzazione	N
value	valore	N
billboard	tabellone	N
engagement	fidanzamento	N
economist	economista	N
bowl	ciotola	N
crane	gru	N
law	legge	N
chapter	capitolo	N
banker	banchiere	N
boot	stivale	N
archbishop	arcivescovo	N
burger	hamburger	N
politician	politico	N
gorilla	gorilla	N
oscilloscope	oscilloscopio	N
boardwalk	passerella	N
ignorance	ignoranza	N
pencil	matita	N
crochet	uncinetto	N
theatre	teatro	N
stitch	punto	N
confidence	fiducia	N
word	parola	N
atom	atomo	N
sand	sabbia	N
pain	dolore	N
hymn	inno	N
effort	sforzo	N
fabric	tessuto	N
prince	principe	N
pebble	ciottolo	N
brand	marchio	N
timber	legname	N
fist	pugno	N
agony	agonia	N
highway	autostrada	N
violation	violazione	N
candle	candela	N
holiday	vacanza	N
nature	natura	N
rod	asta	N
shoe	scarpa	N
conquest	conquista	N
doodle	scarabocchio	N
hen	gallina	N
cockatoo	cacatua	N
elevator	ascensore	N
beach	spiaggia	N
jaw	mascella	N
adversary	avversario	N
salary	stipendio	N
vase	vaso	N
mountain	montagna	N
mallard	mallardo	N
shelter	riparo	N
reef	scogliera	N
truck	camion	N
fiction	finzione	N
strawberry	fragola	N
cup	tazza	N
pond	stagno	N
secretary	segretario	N
might	forza	N
electron	elettrone	N
node	nodo	N
father	padre	N
death	morte	N
cake	torta	N
manager	gestore	N
daisy	margherita	N
kid	capretto	N
cotton	cotone	N
tree	albero	N
butterfly	farfalla	N
turkey	tacchino	N
sunshine	luce del sole	N
marrow	midollo	N
profession	professione	N
cross	croce	N
whisker	baffo	N
size	dimensione	N
jump	salto	N
mac	Mac	N
reflection	riflessione	N
warrior	guerriero	N
code	codice	N
work	lavoro	N
bead	perlina	N
diver	tuffatore	N
president	presidente	N
box	box	N
nerve	nervo	N
century	secolo	N
computer	computer	N
ruler	righello	N
hole	foro	N
literature	letteratura	N
harm	danno	N
zebra	zebra	N
dragonfly	libellula	N
railroad	ferrovia	N
enemy	nemico	N
un	un	N
pipe	tubo	N
bedroom	camera da letto	N
manner	modo	N
guitar	chitarra	N
summer	estate	N
institution	istituzione	N
professor	professore	N
fairy	Fata	N
disk	disco	N
appointment	appuntamento	N
buddy	amico	N
coal	carbone	N
bean	fagiolo	N
salad	insalata	N
museum	museo	N
wheat	frumento	N
mud	fango	N
pet	animale domestico	N
perception	percezione	N
skating	pattinaggio	N
child	bambino	N
company	azienda	N
village	villaggio	N
people	persone	N
seed	seme	N
clue	indizio	N
travel	viaggi	N
transformer	trasformatore	N
thumb	pollice	N
road	strada	N
twig	ramoscello	N
tornado	tornado	N
helicopter	elicottero	N
horse	cavallo	N
underwear	biancheria intima	N
brand-new	nuovo di zecca	N
ski	sci	N
lemon	limone	N
conversation	conversazione	N
epidemic	epidemia	N
web	tela	N
hose	tubo flessibile	N
sugar	zucchero	N
construction	costruzione	N
pie	torta	N
haze	foschia	N
waist	vita	N
threat	minaccia	N
leaf	foglia	N
scenery	scenario	N
landscape	paesaggio	N
bubble	bolla	N
income	reddito	N
pigeon	piccione	N
gauge	calibro	N
circle	cerchio	N
trip	viaggio	N
gossip	pettegolezzo	N
oak	quercia	N
vessel	nave	N
graveyard	cimitero	N
battle	battaglia	N
argument	argomento	N
staircase	scala	N
arithmetic	aritmetica	N
situation	situazione	N
steel	acciaio	N
herb	erba	N
show	mostra	N
family	famiglia	N
era	era	N
wig	parrucca	N
bag	sacchetto	N
queen	regina	N
moon	luna	N
abdomen	addome	N
skyscraper	grattacielo	N
wolf	lupo	N
CD	CD	N
dome	cupola	N
chess	scacchi	N
logo	logo	N
lingerie	biancheria intima	N
par	par	N
album	album	N
athlete	atleta	N
bone	osso	N
accident	incidente	N
balloon	palloncino	N
breakfast	colazione	N
ticket	biglietto	N
cocktail	cocktail	N
fame	fama	N
confusion	confusione	N
verdict	verdetto	N
cousin	cugino	N
note	nota	N
angle	angolo	N
season	stagione	N
harbor	porto	N
padlock	lucchetto	N
limb	arto	N
valley	valle	N
right	destra	N
envelope	busta	N
garbage	spazzatura	N
pyramid	piramide	N
information	informazioni	N
silver	argento	N
item	voce	N
infant	neonato	N
food	cibo	N
autumn	autunno	N
nut	dado	N
engine	motore	N
lily	giglio	N
medium	mezzo	N
tooth	dente	N
morning	mattina	N
smoke	fumo	N
concert	concerto	N
jean	tela ruvida	N
movement	movimento	N
stair	scala	N
muscle	muscolo	N
economy	economia	N
husky	rauco	N
biography	biografia	N
television	televisione	N
cactus	cactus	N
whale	balena	N
tag	etichetta	N
carpet	tappeto	N
pig	maiale	N
potato	patata	N
neon	neon	N
fence	recinto	N
spring	primavera	N
railway	ferrovia	N
horn	corno	N
wind	vento	N
bacon	bacon	N
cab	cabina	N
baby	bambino	N
building	edificio	N
day	giorno	N
cheek	guancia	N
model	modello	N
grave	tomba	N
anger	rabbia	N
rail	ferrovia	N
corpse	cadavere	N
racket	racchetta	N
violin	violino	N
carbon	carbonio	N
victor	vincitore	N
meter	metro	N
spine	spina dorsale	N
comfort	comfort	N
barn	fienile	N
adult	adulto	N
straw	paglia	N
donkey	asino	N
spiral	spirale	N
frustration	frustrazione	N
station	stazione	N
galaxy	galassia	N
serpent	serpente	N
christmas	Natale	N
camel	cammello	N
vitamin	vitamina	N
head	testa	N
cottage	casetta	N
skate	razza	N
origami	origami	N
cobra	cobra	N
idea	idea	N
reptile	rettile	N
harbour	porto	N
card	scheda	N
donut	ciambella	N
outfit	attrezzatura	N
rattle	sonaglio	N
saint	santo	N
weed	erbaccia	N
psychology	psicologia	N
hall	sala	N
carriage	trasporto	N
office	ufficio	N
crystal	cristallo	N
surface	superficie	N
employer	datore di lavoro	N
shade	ombra	N
crab	granchio	N
tobacco	tabacco	N
zombie	zombie	N
physician	medico	N
floor	piano	N
haircut	taglio di capelli	N
singer	cantante	N
clip	clip	N
plate	piastra	N
freeway	superstrada	N
cutie	cutie	N
gun	pistola	N
drop	cadere	V
protect	proteggere	V
understand	capire	V
enter	entrare	V
possess	possedere	V
predict	predire	V
play	giocare	V
spend	trascorrere	V
replace	sostituire	V
deny	negare	V
choke	soffocare	V
fail	mancare	V
drip	sgocciolare	V
deliver	consegnare	V
expand	espandere	V
read	leggere	V
accomplish	realizzare	V
obey	obbedire	V
comprehend	comprendere	V
portray	ritrarre	V
realize	realizzare	V
sink	affondare	V
inquire	informarsi	V
leave	lasciare	V
shrink	ridurre	V
get	ottenere	V
keep	tenere	V
investigate	indagare	V
sign	firmare	V
cherish	accarezzare	V
build	costruire	V
appoint	nominare	V
carry	trasportare	V
save	salvare	V
elect	eleggere	V
examine	esaminare	V
fall	cadere	V
hang	appendere	V
hear	sentire	V
feel	sentire	V
disorganize	disorganizzare	V
pursue	perseguire	V
shed	versare	V
restore	ripristinare	V
enjoy	godere	V
argue	discutere	V
acquire	acquisire	V
justify	giustificare	V
do	fare	V
write	scrivere	V
achieve	raggiungere	V
behave	comportarsi	V
seem	sembrare	V
forget	dimenticare	V
conclude	concludere	V
walk	camminare	V
satisfy	soddisfare	V
paint	dipingere	V
go	partire	V
plead	perorare	V
inform	informare	V
buy	acquistare	V
sleep	dormire	V
meet	soddisfare	V
forgive	perdonare	V
please	soddisfare	V
disappear	scomparire	V
participate	partecipare	V
swim	nuotare	V
become	diventare	V
absorb	assorbire	V
steal	rubare	V
add	aggiungere	V
remind	ricordare	V
prove	dimostrare	V
glitter	brillare	V
appear	apparire	V
find	trovare	V
take	prendere	V
ask	chiedere	V
marry	sposare	V
reduce	ridurre	V
sit	sedersi	V
beg	elemosinare	V
wash	lavare	V
explain	spiegare	V
contemplate	contemplare	V
wander	vagare	V
allow	consentire	V
pray	pregare	V
attend	assistere	V
verify	verificare	V
determine	determinare	V
grow	crescere	V
succeed	avere successo	V
kill	uccidere	V
remain	rimanere	V
blur	annebbiare	V
imitate	imitare	V
lose	perdere	V
roam	vagare	V
multiply	moltiplicare	V
learn	imparare	V
lock	bloccare	V
compare	confrontare	V
eat	mangiare	V
borrow	prendere in prestito	V
occur	verificarsi	V
try	provare	V
join	unirsi	V
vanish	svanire	V
deserve	meritare	V
assume	assumere	V
put	mettere	V
recommend	raccomandare	V
discover	scoprire	V
run	funzionare	V
think	pensare	V
create	creare	V
proclaim	proclamare	V
come	venire	V
encourage	incoraggiare	V
live	vivere	V
agree	concordare	V
speak	parlare	V
differ	differire	V
locate	individuare	V
engage	impegnarsi	V
want	desiderare	V
communicate	comunicare	V
ignore	ignorare	V
accept	accettare	V
quit	smettere	V
discourage	scoraggiare	V
declare	dichiarare	V
evaluate	valutare	V
dominate	dominare	V
win	vincere	V
advise	consigliare	V
withdraw	ritirare	V
make	fare	V
give	dare	V
divide	dividere	V
overcome	superare	V
analyze	analizzare	V
imagine	immaginare	V
require	richiedere	V
discuss	discutere	V
inspect	ispezionare	V
acknowledge	riconoscere	V
obtain	ottenere	V
stand	stare	V
cooperate	cooperare	V
hold	tenere	V
destroy	distruggere	V
handle	maneggiare	V
begin	iniziare	V
abandon	abbandonare	V
earn	guadagnare	V
greet	salutare	V
complain	lamentarsi	V
listen	ascoltare	V
rationalize	razionalizzare	V
avoid	evitare	V
originate	provenire	V
receive	ricevere	V
pretend	fingere	V
explore	esplorare	V
sell	vendere	V
stop	fermare	V
reject	rifiutare	V
relax	rilassarsi	V
persuade	persuadere	V
lick	leccare	V
bring	portare	V
sing	cantare	V
fly	volare	V
retain	conservare	V
arrive	arrivare	V
say	dire	V
organize	organizzare	V
choose	scegliere	V
lend	prestare	V
breathe	respirare	V
entertain	intrattenere	V
burn	bruciare	V
knit	lavorare a maglia	V
draw	disegnare	V
clarify	chiarire	V
post	inviare	V
owe	dovere	V
attach	allegare	V
know	sapere	V
arrange	organizzare	V
bear	sopportare	V
curl	arricciare	V
decide	decidere	V
happen	accadere	V
construct	costruire	V
notify	notificare	V
believe	credere	V
defend	difendere	V
gather	raccogliere	V
announce	annunciare	V
send	inviare	V
collect	raccogliere	V
