unnecessary	inutile	A
insane	fou	A
dirty	sale	A
obvious	évident	A
scarce	rare	A
vintage	cru	A
rapid	rapide	A
ashamed	honteux	A
orange	orange	A
happy	heureux	A
black	noir	A
normal	normal	A
pink	rose	A
graphic	graphique	A
hot	chaud	A
important	important	A
friendly	amical	A
dead	mort	A
bad	mauvais	A
outdoor	de plein air	A
narrow	étroit	A
crazy	fou	A
dreary	morne	A
great	grand	A
anxious	anxieux	A
abstract	abstrait	A
cruel	cruel	A
difficult	difficile	A
clever	intelligent	A
tall	grand	A
broad	large	A
female	femelle	A
tropical	tropical	A
different	différent	A
foolish	insensé	A
underwater	sous l'eau	A
sunny	ensoleillé	A
glad	heureux	A
simple	simple	A
bold	audacieux	A
sharp	pointu	A
sure	sûr	A
restless	agité	A
blue	bleu	A
intelligent	intelligent	A
brown	brun	A
mad	fou	A
smart	intelligent	A
exotic	exotique	A
key	clé	A
cute	mignon	A
military	militaire	A
frigid	froid	A
large	grand	A
white	blanc	A
nice	agréable	A
dull	terne	A
yellow	jaune	A
old	vieux	A
underground	souterrain	A
dumb	muet	A
funny	drôle	A
sweet	doux	A
sexy	sexy	A
wet	humide	A
industrial	industriel	A
fast	rapide	A
afraid	désolé	A
rough	rugueux	A
feline	félin	A
sly	sournois	A
wild	sauvage	A
laden	chargé	A
modest	modeste	A
ancient	ancien	A
tough	difficile	A
illegal	illégal	A
easy	facile	A
immoral	immoral	A
urban	urbain	A
wonderful	merveilleux	A
young	jeune	A
cheerful	gai	A
strong	fort	A
beautiful	beau	A
crucial	crucial	A
unhappy	malheureux	A
proud	fier	A
dense	dense	A
weird	bizarre	A
wide	large	A
blonde	blond	A
fragile	fragile	A
pregnant	enceinte	A
uniform	uniforme	A
quick	rapide	A
bright	brillant	A
violent	violent	A
terrible	terrible	A
recent	récent	A
essential	essentiel	A
canine	canin	A
honest	honnête	A
rare	rare	A
stupid	stupide	A
sick	malade	A
square	carré	A
flexible	flexible	A
inexpensive	peu coûteux	A
modern	moderne	A
childish	puéril	A
harsh	dur	A
heavy	lourd	A
misty	brumeux	A
grey	gris	A
proper	correct	A
nude	nu	A
tiny	minuscule	A
cold	froid	A
necessary	nécessaire	A
confident	confiant	A
colorful	imagé	A
red	rouge	A
odd	impair	A
cheap	bon marché	A
short	court	A
small	petit	A
hard	dur	A
certain	certain	A
strange	étrange	A
fresh	frais	A
concrete	concret	A
new	nouveau	A
guilty	coupable	A
noticeable	perceptible	A
long	long	A
green	vert	A
angry	en colère	A
polite	poli	A
sad	triste	A
impatient	impatient	A
frozen	gelé	A
formal	formel	A
bizarre	bizarre	A
generous	généreux	A
big	grand	A
rusty	rouillé	A
huge	énorme	A
purple	pourpre	A
dark	sombre	A
aerial	aérien	A
awful	terrible	A
terrific	formidable	A
downtown	centre ville	A
miniature	miniature	A
apparent	apparent	A
ceramic	céramique	A
delightful	délicieux	A
elastic	élastique	A
lighthouse	phare	N
universe	univers	N
whiskey	whisky	N
essay	essai	N
belt	ceinture	N
university	université	N
colt	poulain	N
pantyhose	collant	N
commonwealth	Commonwealth	N
lighting	éclairage	N
cube	cube	N
duck	canard	N
pin	épingle	N
insight	perspicacité	N
discussion	discussion	N
rainbow	arc-en-ciel	N
prestige	prestige	N
trail	sentier	N
daffodil	jonquille	N
tongue	langue	N
porch	porche	N
choice	choix	N
lover	amant	N
cowboy	cow-boy	N
nephew	neveu	N
unicorn	licorne	N
fish	poisson	N
sheep	mouton	N
island	île	N
finger	doigt	N
captain	capitaine	N
grape	grain de raisin	N
magazine	magazine	N
totem	totem	N
locomotive	locomotive	N
dude	mec	N
belly	ventre	N
swimsuit	maillot de bain	N
penguin	manchot	N
weather	temps	N
mill	moulin	N
grief	douleur	N
diet	régime	N
emotion	émotion	N
cop	flic	N
intelligence	intelligence	N
catastrophe	catastrophe	N
rattlesnake	crotale	N
date	date	N
molecule	molécule	N
telephone	téléphone	N
jellyfish	méduse	N
apple	pomme	N
sticker	autocollant	N
rabbit	lapin	N
plane	plan	N
comet	comète	N
banana	banane	N
light	lumière	N
gin	gin	N
break	pause	N
music	musique	N
painting	peinture	N
shepherd	berger	N
clothes	vêtements	N
author	auteur	N
scratch	rayure	N
clock	horloge	N
graph	graphique	N
hut	cabane	N
destruction	destruction	N
transition	transition	N
sequence	séquence	N
bell	cloche	N
mirror	miroir	N
crack	fissure	N
sense	sens	N
cage	cage	N
snake	serpent	N
lock	écluse	N
organ	organe	N
bush	buisson	N
instructor	instructeur	N
newspaper	journal	N
hallway	couloir	N
meat	viande	N
escalator	escalator	N
graffito	graffito	N
hero	héros	N
proof	preuve	N
game	jeu	N
incident	incident	N
root	racine	N
priest	prêtre	N
ethidium	éthidium	N
place	lieu	N
area	zone	N
rust	rouille	N
key	clé	N
drawer	tiroir	N
ipod	ipod	N
reading	lecture	N
money	argent	N
aisle	allée	N
arch	cambre	N
map	carte	N
camp	camp	N
object	objet	N
princess	princesse	N
devil	diable	N
jail	prison	N
companion	compagnon	N
middle	milieu	N
bias	préjugé	N
sentry	sentinelle	N
planet	planète	N
industry	industrie	N
decoration	décoration	N
bat	batte	N
gravestone	pierre tombale	N
skin	peau	N
element	élément	N
rabbi	rabbin	N
nucleus	noyau	N
mob	foule	N
god	dieu	N
gel	gel	N
step	étape	N
sailor	marin	N
device	dispositif	N
style	style	N
west	ouest	N
actor	acteur	N
goal	objectif	N
bull	taureau	N
machine	machine	N
scientist	scientifique	N
flood	inondation	N
alcohol	alcool	N
fisherman	pêcheur	N
turtle	tortue	N
phoenix	phénix	N
flour	farine	N
champion	champion	N
flame	flamme	N
peel	zeste	N
fever	fièvre	N
crib	lit de bébé	N
arrow	flèche	N
age	âge	N
winter	hiver	N
temper	humeur	N
beauty	beauté	N
display	exposition	N
sea	mer	N
anchor	ancre	N
story	histoire	N
curve	courbe	N
sauce	sauce	N
film	film	N
soul	âme	N
mammal	mammifère	N
morphism	morphisme	N
depth	profondeur	N
petal	pétale	N
jazz	jazz	N
blackamoor	Blackamoor	N
squirrel	écureuil	N
quantum	quantum	N
hound	chien	N
bakery	boulangerie	N
sunflower	tournesol	N
goo	goo	N
garden	jardin	N
iron	fer	N
chopper	hachoir	N
nest	nid	N
sport	sport	N
shirt	chemise	N
bud	bourgeon	N
corporation	corporation	N
river	rivière	N
poodle	caniche	N
pizza	pizza	N
thing	chose	N
sunlight	soleil	N
sunglasses	lunettes de soleil	N
entity	entité	N
endurance	endurance	N
cloud	nuage	N
goose	oie	N
metro	métro	N
bucket	seau	N
seashore	rivage	N
night	nuit	N
alley	ruelle	N
asphalt	asphalte	N
event	événement	N
border	frontière	N
canyon	canyon	N
koala	koala	N
figure	figure	N
snowman	bonhomme de neige	N
pug	carlin	N
wine	vin	N
fungus	fongus	N
boundary	limite	N
animal	animal	N
sinner	pécheur	N
caterpillar	chenille	N
brick	brique	N
hockey	hockey	N
hip	hanche	N
article	article	N
dirt	saleté	N
distraction	distraction	N
basketball	basket-ball	N
news	nouvelles	N
sword	épée	N
sickness	maladie	N
jar	pot	N
dolphin	dauphin	N
knight	chevalier	N
calf	veau	N
tulip	tulipe	N
sheriff	shérif	N
cookie	gâteau	N
mood	humeur	N
wool	laine	N
toddler	tout petit	N
football	football	N
wisdom	sagesse	N
advertisement	annonce	N
damsel	demoiselle	N
door	porte	N
ghost	fantôme	N
lion	lion	N
candy	bonbon	N
punk	punk	N
mouse	souris	N
ford	gué	N
victory	victoire	N
jaguar	jaguar	N
order	ordre	N
slowdown	ralentissement	N
partition	partition	N
celebrity	célébrité	N
helium	hélium	N
moment	moment	N
raspberry	framboise	N
theme	thème	N
hat	chapeau	N
course	cours	N
flight	vol	N
cucumber	concombre	N
skirt	jupe	N
moose	élan	N
belief	croyance	N
oil	huile	N
diffraction	diffraction	N
seat	siège	N
ob	ob	N
tear	larme	N
orb	orbe	N
baracudda	barracuda	N
witch	sorcière	N
page	page	N
region	région	N
stamp	timbre	N
ball	balle	N
house	maison	N
happiness	bonheur	N
bed	lit	N
topic	sujet	N
cone	cône	N
target	cible	N
pre	pré	N
leather	cuir	N
wedding	mariage	N
view	vue	N
college	collège	N
sample	échantillon	N
landmark	repère	N
tunnel	tunnel	N
tax	impôt	N
round	ronde	N
dream	rêve	N
denial	dénégation	N
fraud	fraude	N
brow	front	N
prey	proie	N
helper	auxiliaire	N
dinner	dîner	N
sidewalk	trottoir	N
poster	affiche	N
roof	toit	N
vinegar	vinaigre	N
table	table	N
bike	vélo	N
dictionary	dictionnaire	N
vinyl	vinyle	N
puppy	chiot	N
surf	surf	N
can	boîte	N
path	chemin	N
spoon	cuillère	N
flu	grippe	N
presence	présence	N
dessert	dessert	N
art	art	N
ice	glace	N
airplane	avion	N
desert	désert	N
chain	chaîne	N
interest	intérêt	N
droplet	gouttelette	N
magnitude	ampleur	N
battery	batterie	N
zoo	zoo	N
bus	bus	N
illusion	illusion	N
skateboard	skateboard	N
poppy	pavot	N
ability	capacité	N
chocolate	chocolat	N
second	deuxième	N
goat	chèvre	N
mermaid	sirène	N
shop	boutique	N
deck	pont	N
hostility	hostilité	N
sushi	Sushi	N
castle	château	N
king	roi	N
man	homme	N
canal	canal	N
cigar	cigare	N
lung	poumon	N
vehicle	véhicule	N
opinion	opinion	N
statue	statue	N
smoking	tabagisme	N
mosque	mosquée	N
hair	cheveux	N
side	côté	N
window	fenêtre	N
mouth	bouche	N
diamond	diamant	N
ox	bœuf	N
pattern	motif	N
chair	chaise	N
dandelion	pissenlit	N
vision	vision	N
polyester	polyester	N
eye	œil	N
wife	femme	N
misery	misère	N
pub	pub	N
bloom	fleur	N
gull	mouette	N
kitty	minou	N
definition	définition	N
chipmunk	chipmunk	N
top	haut	N
pilot	pilote	N
suds	eau savonneuse	N
cell	cellule	N
tombstone	pierre tombale	N
person	personne	N
jacket	veste	N
shadow	ombre	N
monkey	singe	N
attention	attention	N
ledge	rebord	N
panda	panda	N
pollution	pollution	N
ladder	échelle	N
city	ville	N
cheese	fromage	N
photographer	photographe	N
chief	chef	N
pumpkin	citrouille	N
sandwich	sandwich	N
doctor	médecin	N
impression	impression	N
non	non	N
employee	employé	N
chapel	chapelle	N
linen	lin	N
boy	garçon	N
casino	casino	N
actress	actrice	N
wound	plaie	N
stuff	substance	N
beetle	scarabée	N
cafe	café	N
pot	pot	N
burial	enterrement	N
foot	pied	N
cannon	canon	N
criticism	critique	N
product	produit	N
corridor	couloir	N
sun	soleil	N
pair	paire	N
composer	compositeur	N
marble	marbre	N
noodle	nouille	N
circumstance	circonstance	N
character	caractère	N
color	couleur	N
fur	fourrure	N
monument	monument	N
inn	auberge	N
charcoal	charbon de bois	N
lamp	lampe	N
TV	téléviseur	N
camera	caméra	N
self	soi	N
library	bibliothèque	N
interior	intérieur	N
diner	dîneur	N
bird	oiseau	N
texture	texture	N
triumph	triomphe	N
pride	fierté	N
slide	diapositive	N
horizon	horizon	N
egg	œuf	N
bishop	évêque	N
craft	artisanat	N
nose	nez	N
stomach	estomac	N
attorney	mandataire	N
phenomenon	phénomène	N
mug	chope	N
grade	qualité	N
frame	cadre	N
passion	passion	N
concept	concept	N
elephant	éléphant	N
heroine	héroïne	N
owl	hibou	N
nation	nation	N
storm	tempête	N
number	nombre	N
bikini	bikini	N
leader	leader	N
poverty	pauvreté	N
tile	tuile	N
friend	ami	N
car	voiture	N
creator	créateur	N
cord	corde	N
choir	chœur	N
motorcycle	moto	N
log	bûche	N
beef	bœuf	N
guardian	tuteur	N
spirit	esprit	N
collection	collection	N
colour	couleur	N
supper	souper	N
guy	gars	N
woman	femme	N
intuition	intuition	N
lake	lac	N
fountain	fontaine	N
flag	drapeau	N
celebration	célébration	N
ballad	ballade	N
pier	jetée	N
vine	vigne	N
line	ligne	N
evening	soir	N
surfer	surfeur	N
atmosphere	atmosphère	N
bulb	ampoule	N
shoulder	épaule	N
rice	riz	N
population	population	N
rally	rassemblement	N
steak	steak	N
murder	meurtre	N
brain	cerveau	N
aggression	agression	N
cross-section	coup transversale	N
lizard	lézard	N
shame	honte	N
costume	costume	N
mask	masque	N
hamburger	hamburger	N
com	com	N
aunt	tante	N
swimming	natation	N
attitude	attitude	N
peace	paix	N
knee	genou	N
skeleton	squelette	N
legion	légion	N
aquarium	aquarium	N
cow	vache	N
soup	soupe	N
rectangle	rectangle	N
restaurant	restaurant	N
daughter	fille	N
election	élection	N
absence	absence	N
meteor	météore	N
iceberg	iceberg	N
tumor	tumeur	N
job	emploi	N
kite	milan	N
printer	imprimeur	N
handwriting	écriture	N
match	match	N
factory	usine	N
coffee	café	N
anatomy	anatomie	N
cherry	cerise	N
meal	repas	N
cloth	tissu	N
dentist	dentiste	N
farm	ferme	N
equation	équation	N
sky	ciel	N
dawn	aube	N
berry	baie	N
fury	fureur	N
science	science	N
dad	papa	N
pepper	poivre	N
state	État	N
dinosaur	dinosaure	N
melody	mélodie	N
chicken	poulet	N
lawyer	avocat	N
assignment	affectation	N
coast	côte	N
van	van	N
teacher	professeur	N
glove	gant	N
ceremony	cérémonie	N
hummingbird	colibri	N
picture	image	N
spider	araignée	N
management	gestion	N
stadium	stade	N
prisoner	prisonnier	N
fruit	fruit	N
pelican	pélican	N
teeth	dent	N
men	hommes	N
career	carrière	N
capital	capital	N
ruin	ruine	N
bench	banc	N
journal	journal	N
aircraft	aéronef	N
business	entreprise	N
parrot	perroquet	N
pitcher	lanceur	N
wire	fil électrique	N
racing	courses	N
country	pays	N
interval	intervalle	N
image	image	N
fiend	démon	N
groom	jeune marié	N
south	sud	N
sorrow	douleur	N
foliage	feuillage	N
uncle	oncle	N
song	chanson	N
continent	continent	N
metal	métal	N
band	bande	N
stream	courant	N
language	langue	N
goddess	déesse	N
grass	herbe	N
feather	plume	N
anarchy	anarchie	N
tattoo	tatouage	N
dog	chien	N
signature	signature	N
couple	couple	N
snow	neige	N
motel	motel	N
palm	paume	N
carnival	carnaval	N
port	port	N
bottle	bouteille	N
chest	poitrine	N
sketch	esquisse	N
fun	amusement	N
design	désign	N
nun	religieuse	N
fraternity	fraternité	N
sportsman	sportif	N
community	communauté	N
dance	danse	N
task	tâche	N
smile	sourire	N
apartment	appartement	N
letter	lettre	N
maple	érable	N
elbow	coude	N
officer	officier	N
shark	requin	N
bread	pain	N
shopping	shopping	N
architecture	architecture	N
life	vie	N
blossom	fleur	N
gravesite	fossé	N
face	face	N
crow	corneille	N
sofa	sofa	N
photo	photo	N
stencil	pochoir	N
protest	protestation	N
cattle	bovins	N
blanket	couverture	N
orchid	orchidée	N
swing	swing	N
wasp	guêpe	N
water	eau	N
ceiling	plafond	N
jet	jet	N
mare	jument	N
teenager	adolescent	N
mustard	moutarde	N
exit	sortie	N
beast	bête	N
pseudo-scorpion	pseudo-scorpion	N
hill	colline	N
lawn	pelouse	N
hospital	hôpital	N
motor	moteur	N
partner	partenaire	N
kiss	baiser	N
movie	film	N
kitten	chaton	N
store	magasin	N
hysteria	hystérie	N
amphibian	amphibie	N
desk	bureau	N
throat	gorge	N
liver	foie	N
doll	poupée	N
librarian	bibliothécaire	N
lego	jeu Lego	N
mannequin	mannequin	N
seal	phoque	N
memorial	mémorial	N
menu	menu	N
tragedy	tragédie	N
skyline	ligne d'horizon	N
salt	sel	N
leg	jambe	N
race	course	N
tail	queue	N
yard	cour	N
ankle	cheville	N
plenty	abondance	N
noise	bruit	N
deer	cerf	N
sphere	sphère	N
danger	danger	N
grid	grille	N
shell	coquille	N
terrier	terrier	N
body	corps	N
tower	tour	N
deity	déité	N
sailing	départ	N
surgery	chirurgie	N
stag	cerf	N
cigarette	cigarette	N
rock	rock	N
week	semaine	N
auto	auto	N
guest	client	N
winner	gagnant	N
cemetery	cimetière	N
field	champ	N
lens	lentille	N
lamb	agneau	N
violet	violet	N
carrot	carotte	N
seagull	mouette	N
society	société	N
milk	lait	N
shore	rive	N
indent	contrat	N
chaos	chaos	N
tea	thé	N
ripple	ondulation	N
piano	piano	N
organization	organisation	N
illness	maladie	N
rat	rat	N
nail	clou	N
pole	pôle	N
tv	téléviseur	N
pod	cosse	N
cheerleader	Majorette	N
room	chambre	N
sin	péché	N
eagle	aigle	N
trial	procès	N
lady	dame	N
mist	brouillard	N
difficulty	difficulté	N
hawk	faucon	N
wave	vague	N
butter	beurre	N
wealth	richesse	N
necklace	collier	N
soldier	soldat	N
purse	bourse	N
wagon	wagon	N
fraser	fraser	N
sunset	coucher du soleil	N
festival	festival	N
cellar	cave	N
inch	pouce	N
musician	musicien	N
sweater	chandail	N
biology	biologie	N
weekend	weekend	N
quest	quête	N
army	armée	N
tram	tram	N
valentine	Valentin	N
orchestra	orchestre	N
competence	compétence	N
slice	tranche	N
palace	palais	N
santa	Père Noël	N
stocking	stockage	N
abundance	abondance	N
sock	chaussette	N
defect	défaut	N
administration	administration	N
skill	compétence	N
stork	cigogne	N
tomato	tomate	N
edge	bord	N
drizzle	bruine	N
blade	lame	N
bridge	pont	N
bug	insecte	N
demolition	démolition	N
bicycle	vélo	N
monk	moine	N
umbrella	parapluie	N
clown	pitre	N
folder	dossier	N
rebel	rebelle	N
taxi	taxi	N
sign	signe	N
bottom	bas	N
dollar	dollar	N
worker	travailleur	N
safety	sécurité	N
writer	écrivain	N
maker	fabricant	N
ivy	lierre	N
giraffe	girafe	N
robot	robot	N
mayor	maire	N
temple	temple	N
puppet	fantoche	N
male	mâle	N
chemistry	chimie	N
mom	maman	N
artist	artiste	N
ray	rayon	N
ant	fourmi	N
exhibition	exposition	N
pregnancy	grossesse	N
fee	frais	N
communication	communication	N
patio	patio	N
ocean	océan	N
quilt	courtepointe	N
limousine	limousine	N
dress	robe	N
orthodontist	orthodontiste	N
pillow	oreiller	N
stud	goujon	N
corner	coin	N
fact	fait	N
panorama	panorama	N
cancer	cancer	N
bee	abeille	N
particle	particule	N
brother	frère	N
photograph	photo	N
makeup	maquillage	N
bunny	Jeannot lapin	N
faun	faune	N
dew	rosée	N
school	école	N
badge	badge	N
parking	parking	N
paw	patte	N
destination	destination	N
bride	jeune mariée	N
skull	crâne	N
cheetah	guépard	N
lab	laboratoire	N
wing	aile	N
plump	dodu	N
paper	papier	N
vacation	vacances	N
cream	crème	N
heart	cœur	N
strength	force	N
cathedral	cathédrale	N
joy	joie	N
segment	segment	N
love	amour	N
collar	collier	N
drug	médicament	N
crucifix	crucifix	N
toilet	toilette	N
wizard	sorcier	N
knife	couteau	N
chick	poussin	N
sub	sous	N
teddy	nounours	N
market	marché	N
phrase	phrase	N
reader	lecteur	N
colonel	colonel	N
boxer	boxeur	N
scream	cri	N
navy	marine	N
fetus	fœtus	N
creature	créature	N
dancer	danseur	N
girl	fille	N
nurse	infirmière	N
pool	piscine	N
juice	jus	N
wheel	roue	N
lantern	lanterne	N
liquor	alcool	N
hamster	hamster	N
drive	drive	N
furniture	meubles	N
neck	cou	N
scooter	scooter	N
rain	pluie	N
sculpture	sculpture	N
lip	lèvre	N
decade	décennie	N
backdrop	toile de fond	N
footprint	empreinte	N
copper	cuivre	N
astronaut	astronaute	N
basket	panier	N
swastika	svastika	N
postcard	carte postale	N
year	année	N
air	air	N
maid	servante	N
bath	bain	N
tin	étain	N
pupil	élève	N
bullet	balle	N
emergency	urgence	N
triangle	triangle	N
toe	orteil	N
cooking	cuisine	N
rocket	fusée	N
club	club	N
condition	condition	N
cereal	céréale	N
ink	encre	N
barracuda	barracuda	N
calendar	calendrier	N
birthday	anniversaire	N
bomb	bombe	N
opponent	adversaire	N
orange	orange	N
august	août	N
gentleman	gentilhomme	N
rodent	rongeur	N
crown	couronne	N
zone	zone	N
keyboard	clavier	N
gate	porte	N
flamingo	flamant	N
street	rue	N
dragon	dragon	N
pearl	perle	N
cabin	cabine	N
church	église	N
mechanic	mécanicien	N
disc	disque	N
wood	bois	N
fire	feu	N
payment	paiement	N
disease	maladie	N
photography	photographie	N
windmill	moulin à vent	N
garage	garage	N
party	partie	N
arm	bras	N
action	action	N
fantasy	fantaisie	N
dusk	crépuscule	N
awareness	conscience	N
candidate	candidat	N
silhouette	silhouette	N
phone	téléphone	N
stone	pierre	N
swan	cygne	N
journey	voyage	N
redhead	roux	N
agreement	accord	N
baseball	base-ball	N
confession	confession	N
glass	verre	N
traffic	trafic	N
smiley	smiley	N
minister	ministre	N
vein	veine	N
steeple	clocher	N
forest	forêt	N
demon	démon	N
brandy	brandy	N
firework	feu d'artifice	N
time	temps	N
rhythm	rythme	N
quote	citation	N
volcano	volcan	N
lunch	déjeuner	N
fishing	pêche	N
marijuana	marijuana	N
cardboard	carton	N
book	livre	N
champagne	champagne	N
appliance	appareil	N
passport	passeport	N
gasoline	essence	N
police	police	N
world	monde	N
luck	chance	N
crowd	foule	N
bay	baie	N
formula	formule	N
cavern	caverne	N
ear	oreille	N
way	façon	N
paragraph	paragraphe	N
driver	conducteur	N
parade	parade	N
beverage	boisson	N
loop	boucle	N
drum	tambour	N
hand	main	N
insect	insecte	N
culture	culture	N
ad	annonce	N
coin	pièce de monnaie	N
document	document	N
theft	vol	N
kitchen	cuisine	N
capability	capacité	N
container	récipient	N
waterfall	cascade	N
aviation	aviation	N
squad	équipe	N
explosion	explosion	N
stripe	bande	N
rose	rose	N
cradle	berceau	N
ship	navire	N
home	maison	N
iris	iris	N
jewelry	bijoux	N
minute	minute	N
bar	bar	N
elegance	élégance	N
button	bouton	N
toy	jouet	N
moss	mousse	N
frost	gel	N
rope	corde	N
flesh	chair	N
train	train	N
vertex	sommet	N
scene	scène	N
bunch	bouquet	N
illustration	illustration	N
artwork	ouvrages d'art	N
parent	mère	N
pleasure	plaisir	N
town	ville	N
flower	fleur	N
gut	intestin	N
star	star	N
hurricane	ouragan	N
month	mois	N
trick	truc	N
kidney	rein	N
wall	mur	N
bracelet	bracelet	N
despair	désespoir	N
crime	crime	N
hotel	hôtel	N
collage	collage	N
couch	canapé	N
swamp	marais	N
sunrise	lever du soleil	N
instrument	instrument	N
booth	cabine	N
cliff	falaise	N
monster	monstre	N
mink	vison	N
con	escroquerie	N
symbol	symbole	N
cent	cent	N
globe	globe	N
robbery	vol	N
point	point	N
peacock	paon	N
track	piste	N
tiger	tigre	N
gymnastics	gymnastique	N
section	section	N
class	classe	N
wrist	poignet	N
aluminum	aluminium	N
horseman	cavalier	N
reality	réalité	N
fashion	mode	N
son	fils	N
mural	mural	N
infection	infection	N
frog	grenouille	N
mushroom	champignon	N
beard	barbe	N
plough	charrue	N
fingerprint	empreinte digitale	N
tank	réservoir	N
bible	Bible	N
fog	brouillard	N
puddle	flaque	N
fox	renard	N
beer	bière	N
airport	aéroport	N
pact	pacte	N
closet	toilettes	N
husband	mari	N
patient	patient	N
classroom	classe	N
subway	métro	N
plant	plante	N
curtain	rideau	N
boat	bateau	N
scheme	schème	N
text	texte	N
bathroom	salle de bain	N
honey	miel	N
stewardess	hôtesse	N
splash	éclaboussure	N
cat	chat	N
branch	branche	N
theory	théorie	N
park	parc	N
lifetime	vie	N
mother	mère	N
doorway	porte	N
homomorphism	homomorphisme	N
logic	logique	N
student	étudiant	N
coat	manteau	N
neighborhood	quartier	N
justice	justice	N
automobile	voiture	N
activity	activité	N
north	nord	N
gold	or	N
kangaroo	kangourou	N
haven	havre	N
exoplanet	exoplanète	N
angel	ange	N
alligator	alligator	N
portrait	portrait	N
dye	colorant	N
blood	sang	N
organisation	organisation	N
value	valeur	N
billboard	panneau d'affichage	N
engagement	engagement	N
economist	économiste	N
bowl	bol	N
crane	grue	N
law	droit	N
chapter	chapitre	N
banker	banquier	N
boot	botte	N
archbishop	archevêque	N
burger	Burger	N
politician	politicien	N
gorilla	gorille	N
oscilloscope	oscilloscope	N
boardwalk	promenade	N
ignorance	ignorance	N
pencil	crayon	N
crochet	ouvrage au crochet	N
theatre	théâtre	N
stitch	point	N
confidence	confiance	N
word	mot	N
atom	atome	N
sand	sable	N
pain	douleur	N
hymn	hymne	N
effort	effort	N
fabric	tissu	N
prince	prince	N
pebble	caillou	N
brand	marque	N
timber	bois	N
fist	poing	N
agony	agonie	N
highway	autoroute	N
violation	violation	N
candle	bougie	N
holiday	vacances	N
nature	nature	N
rod	barre	N
shoe	chaussure	N
conquest	conquête	N
doodle	griffonnage	N
hen	poule	N
cockatoo	cacatoès	N
elevator	ascenseur	N
beach	plage	N
jaw	mâchoire	N
adversary	adversaire	N
salary	salaire	N
vase	vase	N
mountain	montagne	N
mallard	colvert	N
shelter	abri	N
reef	récif	N
truck	camion	N
fiction	fiction	N
strawberry	fraise	N
cup	tasse	N
pond	étang	N
secretary	secrétaire	N
might	puissance	N
electron	électron	N
node	nœud	N
father	père	N
death	décès	N
cake	gâteau	N
manager	directeur	N
daisy	marguerite	N
kid	enfant	N
cotton	coton	N
tree	arbre	N
butterfly	papillon	N
turkey	dinde	N
sunshine	ensoleillement	N
marrow	moelle	N
profession	profession	N
cross	croix	N
whisker	moustache	N
size	taille	N
jump	saut	N
mac	imperméable	N
reflection	réflexion	N
warrior	guerrier	N
code	code	N
work	travail	N
bead	perle	N
diver	plongeur	N
president	président	N
box	boîte	N
nerve	nerf	N
century	siècle	N
computer	ordinateur	N
ruler	règle	N
hole	trou	N
literature	littérature	N
harm	mal	N
zebra	zèbre	N
dragonfly	libellule	N
railroad	chemin de fer	N
enemy	ennemi	N
un	ONU	N
pipe	tuyau	N
bedroom	chambre à coucher	N
manner	manière	N
guitar	guitare	N
summer	été	N
institution	institution	N
professor	professeur	N
fairy	fée	N
disk	disque	N
appointment	nomination	N
buddy	copain	N
coal	charbon	N
bean	haricot	N
salad	salade	N
museum	musée	N
wheat	blé	N
mud	boue	N
pet	animal de compagnie	N
perception	perception	N
skating	patinage	N
child	enfant	N
company	société	N
village	village	N
people	personnes	N
seed	graine	N
clue	indice	N
travel	voyage	N
transformer	transformateur	N
thumb	pouce	N
road	route	N
twig	brindille	N
tornado	tornade	N
helicopter	hélicoptère	N
horse	cheval	N
underwear	lingerie	N
brand-new	tout neuf	N
ski	ski	N
lemon	citron	N
conversation	conversation	N
epidemic	épidémie	N
web	toile	N
hose	tuyau	N
sugar	sucre	N
construction	construction	N
pie	tarte	N
haze	brume	N
waist	taille	N
threat	menace	N
leaf	feuille	N
scenery	paysage	N
landscape	paysage	N
bubble	bulle	N
income	revenu	N
pigeon	pigeon	N
gauge	jauge	N
circle	cercle	N
trip	voyage	N
gossip	potins	N
oak	chêne	N
vessel	navire	N
graveyard	cimetière	N
battle	bataille	N
argument	argument	N
staircase	escalier	N
arithmetic	arithmétique	N
situation	situation	N
steel	acier	N
herb	herbe	N
show	spectacle	N
family	famille	N
era	ère	N
wig	perruque	N
bag	sac	N
queen	reine	N
moon	lune	N
abdomen	abdomen	N
skyscraper	gratte-ciel	N
wolf	loup	N
CD	CD	N
dome	dôme	N
chess	échecs	N
logo	logo	N
lingerie	lingerie	N
par	par	N
album	album	N
athlete	athlète	N
bone	os	N
accident	accident	N
balloon	ballon	N
breakfast	petit déjeuner	N
ticket	billet	N
cocktail	cocktail	N
fame	gloire	N
confusion	confusion	N
verdict	verdict	N
cousin	cousin	N
note	note	N
angle	angle	N
season	saison	N
harbor	port	N
padlock	cadenas	N
limb	membre	N
valley	vallée	N
right	droit	N
envelope	enveloppe	N
garbage	ordures	N
pyramid	pyramide	N
information	information	N
silver	argent	N
item	article	N
infant	bébé	N
food	nourriture	N
autumn	automne	N
nut	écrou	N
engine	moteur	N
lily	lis	N
medium	moyen	N
tooth	dent	N
morning	matin	N
smoke	fumée	N
concert	concert	N
jean	jean	N
movement	mouvement	N
stair	marche	N
muscle	muscle	N
economy	économie	N
husky	chien de traîneau	N
biography	biographie	N
television	télévision	N
cactus	cactus	N
whale	baleine	N
tag	marque	N
carpet	tapis	N
pig	porc	N
potato	pomme de terre	N
neon	néon	N
fence	clôture	N
spring	printemps	N
railway	chemin de fer	N
horn	corne	N
wind	vent	N
bacon	bacon	N
cab	cabine	N
baby	bébé	N
building	bâtiment	N
day	jour	N
cheek	joue	N
model	modèle	N
grave	tombe	N
anger	colère	N
rail	rail	N
corpse	cadavre	N
racket	raquette	N
violin	violon	N
carbon	carbone	N
victor	vainqueur	N
meter	mètre	N
spine	colonne vertébrale	N
comfort	confort	N
barn	grange	N
adult	adulte	N
straw	paille	N
donkey	baudet	N
spiral	spirale	N
frustration	frustration	N
station	station	N
galaxy	galaxie	N
serpent	serpent	N
christmas	Noël	N
camel	chameau	N
vitamin	vitamine	N
head	tête	N
cottage	cottage	N
skate	patin	N
origami	origami	N
cobra	cobra	N
idea	idée	N
reptile	reptile	N
harbour	port	N
card	carte	N
donut	beignet	N
outfit	tenue	N
rattle	hochet	N
saint	saint	N
weed	mauvaise herbe	N
psychology	psychologie	N
hall	salle	N
carriage	transport	N
office	bureau	N
crystal	cristal	N
surface	surface	N
employer	employeur	N
shade	ombre	N
crab	crabe	N
tobacco	tabac	N
zombie	zombi	N
physician	médecin	N
floor	étage	N
haircut	coupe de cheveux	N
singer	chanteur	N
clip	agrafe	N
plate	plaque	N
freeway	autoroute	N
cutie	la mignonne	N
gun	pistolet	N
drop	tomber	V
protect	protéger	V
understand	comprendre	V
enter	entrer	V
possess	posséder	V
predict	prédire	V
play	jouer	V
spend	passer	V
replace	remplacer	V
deny	nier	V
choke	étouffer	V
fail	échouer	V
drip	goutter	V
deliver	livrer	V
expand	étendre	V
read	lire	V
accomplish	accomplir	V
obey	obéir	V
comprehend	comprendre	V
portray	représenter	V
realize	réaliser	V
sink	sombrer	V
inquire	renseigner	V
leave	laisser	V
shrink	rétrécir	V
get	obtenir	V
keep	garder	V
investigate	enquêter	V
sign	signer	V
cherish	chérir	V
build	construire	V
appoint	nommer	V
carry	porter	V
save	économiser	V
elect	élire	V
examine	examiner	V
fall	tomber	V
hang	accrocher	V
hear	entendre	V
feel	sentir	V
disorganize	désorganiser	V
pursue	poursuivre	V
shed	perdre	V
restore	restaurer	V
enjoy	jouir	V
argue	argumenter	V
acquire	acquérir	V
justify	justifier	V
do	faire	V
write	écrire	V
achieve	atteindre	V
behave	se comporter	V
seem	sembler	V
forget	oublier	V
conclude	conclure	V
walk	marcher	V
satisfy	satisfaire	V
paint	peindre	V
go	aller	V
plead	plaider	V
inform	informer	V
buy	acheter	V
sleep	dormir	V
meet	rencontrer	V
forgive	pardonner	V
please	plaire	V
disappear	disparaître	V
participate	participer	V
swim	nager	V
become	devenir	V
absorb	absorber	V
steal	voler	V
add	ajouter	V
remind	rappeler	V
prove	prouver	V
glitter	briller	V
appear	apparaître	V
find	trouver	V
take	prendre	V
ask	interroger	V
marry	marier	V
reduce	réduire	V
sit	siéger	V
beg	mendier	V
wash	laver	V
explain	expliquer	V
contemplate	contempler	V
wander	errer	V
allow	permettre	V
pray	prier	V
attend	assister à	V
verify	vérifier	V
determine	déterminer	V
grow	grandir	V
succeed	réussir	V
kill	tuer	V
remain	rester	V
blur	brouiller	V
imitate	imiter	V
lose	perdre	V
roam	errer	V
multiply	multiplier	V
learn	apprendre	V
lock	bloquer	V
compare	comparer	V
eat	manger	V
borrow	emprunter	V
occur	se produire	V
try	essayer	V
join	joindre	V
vanish	disparaître	V
deserve	mériter	V
assume	assumer	V
put	mettre	V
recommend	recommander	V
discover	découvrir	V
run	fonctionner	V
think	penser	V
create	créer	V
proclaim	proclamer	V
come	venir	V
encourage	encourager	V
live	vivre	V
agree	accepter	V
speak	parler	V
differ	différer	V
locate	situer	V
engage	engager	V
want	vouloir	V
communicate	communiquer	V
ignore	ignorer	V
accept	accepter	V
quit	quitter	V
discourage	décourager	V
declare	déclarer	V
evaluate	évaluer	V
dominate	dominer	V
win	gagner	V
advise	conseiller	V
withdraw	retirer	V
make	faire	V
give	donner	V
divide	diviser	V
overcome	surmonter	V
analyze	analyser	V
imagine	imaginer	V
require	exiger	V
discuss	discuter	V
inspect	inspecter	V
acknowledge	reconnaître	V
obtain	obtenir	V
stand	supporter	V
cooperate	coopérer	V
hold	tenir	V
destroy	détruire	V
handle	manipuler	V
begin	commencer	V
abandon	abandonner	V
earn	gagner	V
greet	saluer	V
complain	plaindre	V
listen	ausculter	V
rationalize	rationaliser	V
avoid	éviter	V
originate	produire	V
receive	recevoir	V
pretend	prétendre	V
explore	explorer	V
sell	vendre	V
stop	arrêter	V
reject	rejeter	V
relax	se détendre	V
persuade	persuader	V
lick	lécher	V
bring	apporter	V
sing	chanter	V
fly	voler	V
retain	conserver	V
arrive	arriver	V
say	dire	V
organize	organiser	V
choose	choisir	V
lend	prêter	V
breathe	respirer	V
entertain	divertir	V
burn	brûler	V
knit	tricoter	V
draw	dessiner	V
clarify	clarifier	V
post	poster	V
owe	devoir	V
attach	joindre	V
know	savoir	V
arrange	organiser	V
bear	supporter	V
curl	friser	V
decide	décider	V
happen	arriver	V
construct	construire	V
notify	signifier	V
believe	croire	V
defend	défendre	V
gather	recueillir	V
announce	annoncer	V
send	envoyer	V
collect	recueillir	V
