unnecessary	innecesario	A
insane	insano	A
dirty	sucio	A
obvious	obvio	A
scarce	escaso	A
vintage	de época	A
rapid	rápido	A
ashamed	avergonzado	A
orange	anaranjado	A
happy	feliz	A
black	negro	A
normal	normal	A
pink	rosa	A
graphic	gráfico	A
hot	caliente	A
important	importante	A
friendly	amable	A
dead	muerto	A
bad	malo	A
outdoor	al aire libre	A
narrow	estrecho	A
crazy	loco	A
dreary	triste	A
great	gran	A
anxious	ansioso	A
abstract	abstracto	A
cruel	cruel	A
difficult	difícil	A
clever	inteligente	A
tall	alto	A
broad	ancho	A
female	hembra	A
tropical	tropical	A
different	diferente	A
foolish	tonto	A
underwater	submarino	A
sunny	soleado	A
glad	alegre	A
simple	simple	A
bold	audaz	A
sharp	fuerte	A
sure	seguro	A
restless	inquieto	A
blue	azul	A
intelligent	inteligente	A
brown	marrón	A
mad	loco	A
smart	inteligente	A
exotic	exótico	A
key	llave	A
cute	lindo	A
military	militar	A
frigid	frígido	A
large	gran	A
white	blanco	A
nice	agradable	A
dull	aburrido	A
yellow	amarillo	A
old	viejo	A
underground	subterráneo	A
dumb	mudo	A
funny	divertido	A
sweet	dulce	A
sexy	sexy	A
wet	mojado	A
industrial	industrial	A
fast	rápido	A
afraid	asustado	A
rough	áspero	A
feline	felino	A
sly	astuto	A
wild	salvaje	A
laden	cargado	A
modest	modesto	A
ancient	antiguo	A
tough	difícil	A
illegal	ilegal	A
easy	fácil	A
immoral	inmoral	A
urban	urbano	A
wonderful	maravilloso	A
young	joven	A
cheerful	alegre	A
strong	fuerte	A
beautiful	hermoso	A
crucial	crucial	A
unhappy	infeliz	A
proud	orgulloso	A
dense	denso	A
weird	extraño	A
wide	ancho	A
blonde	rubia	A
fragile	frágil	A
pregnant	embarazada	A
uniform	constante	A
quick	rápido	A
bright	brillante	A
violent	violento	A
terrible	terrible	A
recent	reciente	A
essential	esencial	A
canine	canino	A
honest	honesto	A
rare	raro	A
stupid	estúpido	A
sick	enfermo	A
square	cuadrado	A
flexible	flexible	A
inexpensive	barato	A
modern	moderno	A
childish	infantil	A
harsh	duro	A
heavy	pesado	A
misty	brumoso	A
grey	gris	A
proper	apropiado	A
nude	desnudo	A
tiny	minúsculo	A
cold	frío	A
necessary	necesario	A
confident	seguro	A
colorful	vistoso	A
red	rojo	A
odd	extraño	A
cheap	barato	A
short	corto	A
small	pequeño	A
hard	duro	A
certain	cierto	A
strange	extraño	A
fresh	fresco	A
concrete	concreto	A
new	nuevo	A
guilty	culpable	A
noticeable	notable	A
long	largo	A
green	verde	A
angry	enojado	A
polite	educado	A
sad	triste	A
impatient	impaciente	A
frozen	congelado	A
formal	formal	A
bizarre	extraño	A
generous	generoso	A
big	gran	A
rusty	oxidado	A
huge	enorme	A
purple	morado	A
dark	oscuro	A
aerial	aéreo	A
awful	horrible	A
terrific	estupendo	A
downtown	céntrico	A
miniature	miniatura	A
apparent	aparente	A
ceramic	cerámico	A
delightful	encantador	A
elastic	elástico	A
lighthouse	faro	N
universe	universo	N
whiskey	whisky	N
essay	ensayo	N
belt	cinturón	N
university	universidad	N
colt	potro	N
pantyhose	pantys	N
commonwealth	mancomunidad	N
lighting	iluminación	N
cube	cubo	N
duck	pato	N
pin	perno	N
insight	penetración	N
discussion	discusión	N
rainbow	arco iris	N
prestige	prestigio	N
trail	rastro	N
daffodil	narciso	N
tongue	lengua	N
porch	porche	N
choice	elección	N
lover	amante	N
cowboy	vaquero	N
nephew	sobrino	N
unicorn	unicornio	N
fish	pescado	N
sheep	oveja	N
island	isla	N
finger	dedo	N
captain	capitán	N
grape	uva	N
magazine	revista	N
totem	tótem	N
locomotive	locomotora	N
dude	petimetre	N
belly	vientre	N
swimsuit	traje de baño	N
penguin	pingüino	N
weather	tiempo	N
mill	molino	N
grief	dolor	N
diet	dieta	N
emotion	emoción	N
cop	policía	N
intelligence	inteligencia	N
catastrophe	catástrofe	N
rattlesnake	serpiente de cascabel	N
date	fecha	N
molecule	molécula	N
telephone	teléfono	N
jellyfish	medusa	N
apple	manzana	N
sticker	etiqueta engomada	N
rabbit	conejo	N
plane	plano	N
comet	cometa	N
banana	plátano	N
light	luz	N
gin	ginebra	N
break	rotura	N
music	música	N
painting	pintura	N
shepherd	pastor	N
clothes	ropa	N
author	autor	N
scratch	rasguño	N
clock	reloj	N
graph	gráfico	N
hut	choza	N
destruction	destrucción	N
transition	transición	N
sequence	secuencia	N
bell	campana	N
mirror	espejo	N
crack	grieta	N
sense	sentido	N
cage	jaula	N
snake	serpiente	N
lock	cerradura	N
organ	órgano	N
bush	arbusto	N
instructor	instructor	N
newspaper	periódico	N
hallway	vestíbulo	N
meat	carne	N
escalator	escalera mecánica	N
graffito	graffito	N
hero	héroe	N
proof	prueba	N
game	juego	N
incident	incidente	N
root	raíz	N
priest	sacerdote	N
ethidium	ethidium	N
place	lugar	N
area	área	N
rust	moho	N
key	clave	N
drawer	cajón	N
ipod	ipod	N
reading	lectura	N
money	dinero	N
aisle	pasillo	N
arch	arco	N
map	mapa	N
camp	acampar	N
object	objeto	N
princess	princesa	N
devil	diablo	N
jail	cárcel	N
companion	compañero	N
middle	medio	N
bias	parcialidad	N
sentry	centinela	N
planet	planeta	N
industry	industria	N
decoration	decoración	N
bat	murciélago	N
gravestone	lápida sepulcral	N
skin	piel	N
element	elemento	N
rabbi	rabino	N
nucleus	núcleo	N
mob	multitud	N
god	dios	N
gel	gel	N
step	paso	N
sailor	marinero	N
device	dispositivo	N
style	estilo	N
west	oeste	N
actor	actor	N
goal	objetivo	N
bull	toro	N
machine	máquina	N
scientist	científico	N
flood	inundación	N
alcohol	alcohol	N
fisherman	pescador	N
turtle	tortuga marina	N
phoenix	fénix	N
flour	harina	N
champion	campeón	N
flame	llama	N
peel	piel	N
fever	fiebre	N
crib	cuna	N
arrow	flecha	N
age	edad	N
winter	invierno	N
temper	genio	N
beauty	belleza	N
display	visualización	N
sea	mar	N
anchor	ancla	N
story	historia	N
curve	curva	N
sauce	salsa	N
film	película	N
soul	alma	N
mammal	mamífero	N
morphism	morfismo	N
depth	profundidad	N
petal	pétalo	N
jazz	jazz	N
blackamoor	Blackamoor	N
squirrel	ardilla	N
quantum	quantum	N
hound	sabueso	N
bakery	panadería	N
sunflower	girasol	N
goo	cosa muy pegajosa	N
garden	jardín	N
iron	hierro	N
chopper	helicóptero	N
nest	nido	N
sport	deporte	N
shirt	camisa	N
bud	brote	N
corporation	corporación	N
river	río	N
poodle	caniche	N
pizza	pizza	N
thing	cosa	N
sunlight	luz del sol	N
sunglasses	gafas de sol	N
entity	entidad	N
endurance	resistencia	N
cloud	nube	N
goose	ganso	N
metro	metro	N
bucket	cangilón	N
seashore	costa	N
night	noche	N
alley	callejón	N
asphalt	asfalto	N
event	evento	N
border	frontera	N
canyon	cañón	N
koala	coala	N
figure	figura	N
snowman	monigote de nieve	N
pug	doguillo	N
wine	vino	N
fungus	hongo	N
boundary	límite	N
animal	animal	N
sinner	pecador	N
caterpillar	oruga	N
brick	ladrillo	N
hockey	hockey	N
hip	cadera	N
article	artículo	N
dirt	suciedad	N
distraction	distracción	N
basketball	baloncesto	N
news	noticias	N
sword	espada	N
sickness	enfermedad	N
jar	tarro	N
dolphin	delfín	N
knight	caballero	N
calf	becerro	N
tulip	tulipán	N
sheriff	alguacil	N
cookie	galleta	N
mood	humor	N
wool	lana	N
toddler	niñito	N
football	fútbol	N
wisdom	sabiduría	N
advertisement	anuncio	N
damsel	damisela	N
door	puerta	N
ghost	fantasma	N
lion	león	N
candy	caramelo	N
punk	punk	N
mouse	ratón	N
ford	vado	N
victory	victoria	N
jaguar	jaguar	N
order	orden	N
slowdown	ralentización	N
partition	tabique	N
celebrity	celebridad	N
helium	helio	N
moment	momento	N
raspberry	frambuesa	N
theme	tema	N
hat	sombrero	N
course	curso	N
flight	vuelo	N
cucumber	pepino	N
skirt	falda	N
moose	alce	N
belief	creencia	N
oil	aceite	N
diffraction	difracción	N
seat	asiento	N
ob	transmisión exterior	N
tear	lágrima	N
orb	orbe	N
baracudda	barracuda	N
witch	bruja	N
page	página	N
region	región	N
stamp	sello	N
ball	balón	N
house	casa	N
happiness	felicidad	N
bed	cama	N
topic	tema	N
cone	cono	N
target	objetivo	N
pre	pre	N
leather	cuero	N
wedding	boda	N
view	vista	N
college	colegio	N
sample	muestra	N
landmark	marca	N
tunnel	túnel	N
tax	impuesto	N
round	ronda	N
dream	sueño	N
denial	negación	N
fraud	fraude	N
brow	frente	N
prey	presa	N
helper	ayudante	N
dinner	cena	N
sidewalk	acera	N
poster	póster	N
roof	techo	N
vinegar	vinagre	N
table	mesa	N
bike	bicicleta	N
dictionary	diccionario	N
vinyl	vinilo	N
puppy	perrito	N
surf	olas	N
can	lata	N
path	camino	N
spoon	cuchara	N
flu	gripe	N
presence	presencia	N
dessert	postre	N
art	arte	N
ice	hielo	N
airplane	avión	N
desert	desierto	N
chain	cadena	N
interest	interés	N
droplet	gotita	N
magnitude	magnitud	N
battery	batería	N
zoo	zoo	N
bus	autobús	N
illusion	espejismo	N
skateboard	monopatín	N
poppy	amapola	N
ability	capacidad	N
chocolate	chocolate	N
second	segundo	N
goat	cabra	N
mermaid	sirena	N
shop	tienda	N
deck	cubierta	N
hostility	hostilidad	N
sushi	Sushi	N
castle	castillo	N
king	rey	N
man	hombre	N
canal	canal	N
cigar	cigarro	N
lung	pulmón	N
vehicle	vehículo	N
opinion	opinión	N
statue	estatua	N
smoking	el fumar	N
mosque	mezquita	N
hair	pelo	N
side	lado	N
window	ventana	N
mouth	boca	N
diamond	diamante	N
ox	buey	N
pattern	patrón	N
chair	silla	N
dandelion	diente de león	N
vision	visión	N
polyester	poliéster	N
eye	ojo	N
wife	esposa	N
misery	miseria	N
pub	pub	N
bloom	floración	N
gull	gaviota	N
kitty	bote	N
definition	definición	N
chipmunk	ardilla	N
top	parte superior	N
pilot	piloto	N
suds	jabonaduras	N
cell	célula	N
tombstone	lápida sepulcral	N
person	persona	N
jacket	chaqueta	N
shadow	sombra	N
monkey	mono	N
attention	atención	N
ledge	repisa	N
panda	panda	N
pollution	polución	N
ladder	escalera	N
city	ciudad	N
cheese	queso	N
photographer	fotógrafo	N
chief	jefe	N
pumpkin	calabaza	N
sandwich	sándwich	N
doctor	médico	N
impression	impresión	N
non	no	N
employee	empleado	N
chapel	capilla	N
linen	lino	N
boy	muchacho	N
casino	casino	N
actress	actriz	N
wound	herida	N
stuff	cosas	N
beetle	escarabajo	N
cafe	cafetería	N
pot	olla	N
burial	entierro	N
foot	pie	N
cannon	cañón	N
criticism	crítica	N
product	producto	N
corridor	corredor	N
sun	sol	N
pair	par	N
composer	compositor	N
marble	mármol	N
noodle	cabeza	N
circumstance	circunstancia	N
character	carácter	N
color	color	N
fur	piel	N
monument	monumento	N
inn	posada	N
charcoal	carbón	N
lamp	lámpara	N
TV	televisión	N
camera	cámara	N
self	yo	N
library	biblioteca	N
interior	interior	N
diner	comedor	N
bird	pájaro	N
texture	textura	N
triumph	triunfo	N
pride	orgullo	N
slide	diapositiva	N
horizon	horizonte	N
egg	huevo	N
bishop	obispo	N
craft	arte	N
nose	nariz	N
stomach	estómago	N
attorney	abogado	N
phenomenon	fenómeno	N
mug	jarra	N
grade	grado	N
frame	marco	N
passion	pasión	N
concept	concepto	N
elephant	elefante	N
heroine	heroína	N
owl	búho	N
nation	nación	N
storm	tormenta	N
number	número	N
bikini	bikini	N
leader	líder	N
poverty	pobreza	N
tile	azulejo	N
friend	amigo	N
car	coche	N
creator	creador	N
cord	cable	N
choir	coro	N
motorcycle	motocicleta	N
log	log	N
beef	carne de vaca	N
guardian	guardián	N
spirit	espíritu	N
collection	colección	N
colour	color	N
supper	cena	N
guy	individuo	N
woman	mujer	N
intuition	intuición	N
lake	lago	N
fountain	fuente	N
flag	bandera	N
celebration	celebración	N
ballad	balada	N
pier	muelle	N
vine	vid	N
line	línea	N
evening	tarde	N
surfer	tablista	N
atmosphere	atmósfera	N
bulb	bulbo	N
shoulder	hombro	N
rice	arroz	N
population	población	N
rally	reunión	N
steak	bistec	N
murder	asesinato	N
brain	cerebro	N
aggression	agresión	N
cross-section	sección transversal	N
lizard	lagarto	N
shame	vergüenza	N
costume	traje	N
mask	máscara	N
hamburger	hamburguesa	N
com	com	N
aunt	tía	N
swimming	natación	N
attitude	actitud	N
peace	paz	N
knee	rodilla	N
skeleton	esqueleto	N
legion	legión	N
aquarium	acuario	N
cow	vaca	N
soup	sopa	N
rectangle	rectángulo	N
restaurant	restaurante	N
daughter	hija	N
election	elección	N
absence	ausencia	N
meteor	meteorito	N
iceberg	iceberg	N
tumor	tumor	N
job	trabajo	N
kite	cometa	N
printer	impresora	N
handwriting	escritura	N
match	partido	N
factory	fábrica	N
coffee	café	N
anatomy	anatomía	N
cherry	cereza	N
meal	comida	N
cloth	paño	N
dentist	dentista	N
farm	granja	N
equation	ecuación	N
sky	cielo	N
dawn	amanecer	N
berry	baya	N
fury	furia	N
science	ciencia	N
dad	papá	N
pepper	pimienta	N
state	estado	N
dinosaur	dinosaurio	N
melody	melodía	N
chicken	pollo	N
lawyer	abogado	N
assignment	asignación	N
coast	costa	N
van	furgoneta	N
teacher	profesor	N
glove	guante	N
ceremony	ceremonia	N
hummingbird	colibrí	N
picture	imagen	N
spider	araña	N
management	administración	N
stadium	estadio	N
prisoner	prisionero	N
fruit	fruta	N
pelican	pelícano	N
teeth	dientes	N
men	hombres	N
career	carrera	N
capital	capital	N
ruin	ruina	N
bench	banco	N
journal	revista	N
aircraft	aeronave	N
business	negocios	N
parrot	loro	N
pitcher	lanzador	N
wire	alambre	N
racing	carreras	N
country	país	N
interval	intervalo	N
image	imagen	N
fiend	demonio	N
groom	novio	N
south	sur	N
sorrow	dolor	N
foliage	follaje	N
uncle	tío	N
song	canción	N
continent	continente	N
metal	metal	N
band	banda	N
stream	corriente	N
language	idioma	N
goddess	diosa	N
grass	hierba	N
feather	pluma	N
anarchy	anarquía	N
tattoo	tatuaje	N
dog	perro	N
signature	firma	N
couple	par	N
snow	nieve	N
motel	motel	N
palm	palma	N
carnival	carnaval	N
port	puerto	N
bottle	botella	N
chest	pecho	N
sketch	bosquejo	N
fun	diversión	N
design	diseño	N
nun	monja	N
fraternity	fraternidad	N
sportsman	deportista	N
community	comunidad	N
dance	danza	N
task	tarea	N
smile	sonrisa	N
apartment	apartamento	N
letter	carta	N
maple	arce	N
elbow	codo	N
officer	oficial	N
shark	tiburón	N
bread	pan	N
shopping	compras	N
architecture	arquitectura	N
life	vida	N
blossom	flor	N
gravesite	tumba	N
face	cara	N
crow	cuervo	N
sofa	sofá	N
photo	foto	N
stencil	plantilla	N
protest	protesta	N
cattle	ganado	N
blanket	manta	N
orchid	orquídea	N
swing	oscilación	N
wasp	avispa	N
water	agua	N
ceiling	techo	N
jet	chorro	N
mare	yegua	N
teenager	adolescente	N
mustard	mostaza	N
exit	salida	N
beast	bestia	N
pseudo-scorpion	pseudo-escorpión	N
hill	colina	N
lawn	césped	N
hospital	hospital	N
motor	motor	N
partner	socio	N
kiss	beso	N
movie	película	N
kitten	gatito	N
store	tienda	N
hysteria	histeria	N
amphibian	anfibio	N
desk	escritorio	N
throat	garganta	N
liver	hígado	N
doll	muñeca	N
librarian	bibliotecario	N
lego	Lego	N
mannequin	maniquí	N
seal	sello	N
memorial	memorial	N
menu	menú	N
tragedy	tragedia	N
skyline	horizonte	N
salt	sal	N
leg	pierna	N
race	raza	N
tail	cola	N
yard	yarda	N
ankle	tobillo	N
plenty	abundancia	N
noise	ruido	N
deer	ciervo	N
sphere	esfera	N
danger	peligro	N
grid	red	N
shell	cáscara	N
terrier	terrier	N
body	cuerpo	N
tower	torre	N
deity	deidad	N
sailing	navegación	N
surgery	cirugía	N
stag	ciervo	N
cigarette	cigarrillo	N
rock	roca	N
week	semana	N
auto	auto	N
guest	huésped	N
winner	ganador	N
cemetery	cementerio	N
field	campo	N
lens	lente	N
lamb	cordero	N
violet	violeta	N
carrot	zanahoria	N
seagull	gaviota	N
society	sociedad	N
milk	leche	N
shore	orilla	N
indent	muesca	N
chaos	caos	N
tea	té	N
ripple	onda	N
piano	piano	N
organization	organización	N
illness	enfermedad	N
rat	rata	N
nail	clavo	N
pole	polo	N
tv	televisión	N
pod	vaina	N
cheerleader	animador	N
room	habitación	N
sin	pecado	N
eagle	águila	N
trial	juicio	N
lady	señora	N
mist	niebla	N
difficulty	dificultad	N
hawk	halcón	N
wave	onda	N
butter	mantequilla	N
wealth	riqueza	N
necklace	collar	N
soldier	soldado	N
purse	monedero	N
wagon	vagón	N
fraser	fraser	N
sunset	puesta del sol	N
festival	festival	N
cellar	bodega	N
inch	pulgada	N
musician	músico	N
sweater	suéter	N
biology	biología	N
weekend	fin de semana	N
quest	búsqueda	N
army	ejército	N
tram	tranvía	N
valentine	enamorado	N
orchestra	orquesta	N
competence	competencia	N
slice	rebanada	N
palace	palacio	N
santa	santa	N
stocking	media	N
abundance	abundancia	N
sock	calcetín	N
defect	defecto	N
administration	administración	N
skill	habilidad	N
stork	cigüeña	N
tomato	tomate	N
edge	borde	N
drizzle	llovizna	N
blade	hoja	N
bridge	puente	N
bug	error	N
demolition	demolición	N
bicycle	bicicleta	N
monk	monje	N
umbrella	paraguas	N
clown	payaso	N
folder	carpeta	N
rebel	rebelde	N
taxi	taxi	N
sign	signo	N
bottom	fondo	N
dollar	dólar	N
worker	obrero	N
safety	seguridad	N
writer	escritor	N
maker	fabricante	N
ivy	hiedra	N
giraffe	jirafa	N
robot	robot	N
mayor	alcalde	N
temple	templo	N
puppet	marioneta	N
male	masculino	N
chemistry	química	N
mom	mamá	N
artist	artista	N
ray	rayo	N
ant	hormiga	N
exhibition	exposición	N
pregnancy	embarazo	N
fee	cuota	N
communication	comunicación	N
patio	patio	N
ocean	océano	N
quilt	edredón	N
limousine	limusina	N
dress	vestido	N
orthodontist	ortodoncista	N
pillow	almohada	N
stud	semental	N
corner	esquina	N
fact	hecho	N
panorama	panorama	N
cancer	cáncer	N
bee	abeja	N
particle	partícula	N
brother	hermano	N
photograph	fotografía	N
makeup	maquillaje	N
bunny	conejito	N
faun	fauno	N
dew	rocío	N
school	escuela	N
badge	divisa	N
parking	aparcamiento	N
paw	pata	N
destination	destino	N
bride	novia	N
skull	cráneo	N
cheetah	leopardo cazador	N
lab	laboratorio	N
wing	ala	N
plump	ruido sordo	N
paper	papel	N
vacation	vacaciones	N
cream	crema	N
heart	corazón	N
strength	fuerza	N
cathedral	catedral	N
joy	alegría	N
segment	segmento	N
love	amor	N
collar	collar	N
drug	droga	N
crucifix	crucifijo	N
toilet	inodoro	N
wizard	mago	N
knife	cuchillo	N
chick	polluelo	N
sub	sub	N
teddy	osito de peluche	N
market	mercado	N
phrase	frase	N
reader	lector	N
colonel	coronel	N
boxer	bóxer	N
scream	chillido	N
navy	marina de guerra	N
fetus	feto	N
creature	criatura	N
dancer	bailarín	N
girl	muchacha	N
nurse	enfermera	N
pool	piscina	N
juice	jugo	N
wheel	rueda	N
lantern	linterna	N
liquor	espíritu	N
hamster	hámster	N
drive	drive	N
furniture	muebles	N
neck	cuello	N
scooter	scooter	N
rain	lluvia	N
sculpture	escultura	N
lip	labio	N
decade	década	N
backdrop	fondo	N
footprint	huella	N
copper	cobre	N
astronaut	astronauta	N
basket	cesta	N
swastika	esvástica	N
postcard	tarjeta postal	N
year	año	N
air	aire	N
maid	criada	N
bath	baño	N
tin	estaño	N
pupil	pupila	N
bullet	bala	N
emergency	emergencia	N
triangle	triángulo	N
toe	dedo del pie	N
cooking	cocina	N
rocket	cohete	N
club	club	N
condition	condición	N
cereal	cereal	N
ink	tinta	N
barracuda	barracuda	N
calendar	calendario	N
birthday	cumpleaños	N
bomb	bomba	N
opponent	adversario	N
orange	naranja	N
august	agosto	N
gentleman	caballero	N
rodent	roedor	N
crown	corona	N
zone	zona	N
keyboard	teclado	N
gate	puerta	N
flamingo	flamenco	N
street	calle	N
dragon	dragón	N
pearl	perla	N
cabin	cabina	N
church	iglesia	N
mechanic	mecánico	N
disc	disco	N
wood	madera	N
fire	fuego	N
payment	pago	N
disease	enfermedad	N
photography	fotografía	N
windmill	molino de viento	N
garage	garaje	N
party	fiesta	N
arm	brazo	N
action	acción	N
fantasy	fantasía	N
dusk	oscuridad	N
awareness	conciencia	N
candidate	candidato	N
silhouette	silueta	N
phone	teléfono	N
stone	piedra	N
swan	cisne	N
journey	viaje	N
redhead	pelirrojo	N
agreement	acuerdo	N
baseball	béisbol	N
confession	confesión	N
glass	vidrio	N
traffic	tráfico	N
smiley	smiley	N
minister	ministro	N
vein	vena	N
steeple	campanario	N
forest	bosque	N
demon	demonio	N
brandy	brandy	N
firework	Fuegos artificiales	N
time	tiempo	N
rhythm	ritmo	N
quote	cita	N
volcano	volcán	N
lunch	almuerzo	N
fishing	pesca	N
marijuana	marijuana	N
cardboard	cartulina	N
book	libro	N
champagne	champán	N
appliance	aparato	N
passport	pasaporte	N
gasoline	gasolina	N
police	policía	N
world	mundo	N
luck	suerte	N
crowd	multitud	N
bay	bahía	N
formula	fórmula	N
cavern	caverna	N
ear	oído	N
way	manera	N
paragraph	párrafo	N
driver	conductor	N
parade	desfile	N
beverage	bebida	N
loop	bucle	N
drum	tambor	N
hand	mano	N
insect	insecto	N
culture	cultura	N
ad	anuncio	N
coin	moneda	N
document	documento	N
theft	robo	N
kitchen	cocina	N
capability	capacidad	N
container	recipiente	N
waterfall	cascada	N
aviation	aviación	N
squad	equipo	N
explosion	explosión	N
stripe	raya	N
rose	rosa	N
cradle	cuna	N
ship	barco	N
home	casa	N
iris	iris	N
jewelry	joyería	N
minute	minuto	N
bar	bar	N
elegance	elegancia	N
button	botón	N
toy	juguete	N
moss	musgo	N
frost	helada	N
rope	cuerda	N
flesh	carne	N
train	tren	N
vertex	vértice	N
scene	escena	N
bunch	manojo	N
illustration	ilustración	N
artwork	ilustraciones	N
parent	padre	N
pleasure	placer	N
town	ciudad	N
flower	flor	N
gut	intestino	N
star	estrella	N
hurricane	huracán	N
month	mes	N
trick	truco	N
kidney	riñón	N
wall	pared	N
bracelet	pulsera	N
despair	desesperación	N
crime	crimen	N
hotel	hotel	N
collage	collage	N
couch	sofá	N
swamp	pantano	N
sunrise	salida del sol	N
instrument	instrumento	N
booth	cabina	N
cliff	acantilado	N
monster	monstruo	N
mink	visón	N
con	estafa	N
symbol	símbolo	N
cent	centavo	N
globe	globo	N
robbery	robo	N
point	punto	N
peacock	pavo real	N
track	pista	N
tiger	tigre	N
gymnastics	gimnasia	N
section	sección	N
class	clase	N
wrist	muñeca	N
aluminum	aluminio	N
horseman	jinete	N
reality	realidad	N
fashion	moda	N
son	hijo	N
mural	mural	N
infection	infección	N
frog	rana	N
mushroom	seta	N
beard	barba	N
plough	arado	N
fingerprint	huella dactilar	N
tank	tanque	N
bible	Biblia	N
fog	niebla	N
puddle	charco	N
fox	zorro	N
beer	cerveza	N
airport	aeropuerto	N
pact	pacto	N
closet	armario	N
husband	marido	N
patient	paciente	N
classroom	aula	N
subway	metro	N
plant	planta	N
curtain	cortina	N
boat	barco	N
scheme	esquema	N
text	texto	N
bathroom	cuarto de baño	N
honey	miel	N
stewardess	azafata	N
splash	chapoteo	N
cat	gato	N
branch	rama	N
theory	teoría	N
park	parque	N
lifetime	vida	N
mother	madre	N
doorway	puerta	N
homomorphism	homomorfismo	N
logic	lógica	N
student	estudiante	N
coat	capa	N
neighborhood	barrio	N
justice	justicia	N
automobile	automóvil	N
activity	actividad	N
north	norte	N
gold	oro	N
kangaroo	canguro	N
haven	refugio	N
exoplanet	exoplaneta	N
angel	ángel	N
alligator	caimán	N
portrait	retrato	N
dye	colorante	N
blood	sangre	N
organisation	organización	N
value	valor	N
billboard	cartelera	N
engagement	compromiso	N
economist	economista	N
bowl	tazón	N
crane	grúa	N
law	ley	N
chapter	capítulo	N
banker	banquero	N
boot	bota	N
archbishop	arzobispo	N
burger	hamburguesa	N
politician	político	N
gorilla	gorila	N
oscilloscope	osciloscopio	N
boardwalk	paseo marítimo	N
ignorance	ignorancia	N
pencil	lápiz	N
crochet	croché	N
theatre	teatro	N
stitch	puntada	N
confidence	confianza	N
word	palabra	N
atom	átomo	N
sand	arena	N
pain	dolor	N
hymn	himno	N
effort	esfuerzo	N
fabric	tela	N
prince	príncipe	N
pebble	guijarro	N
brand	marca	N
timber	madera	N
fist	puño	N
agony	agonía	N
highway	carretera	N
violation	violación	N
candle	vela	N
holiday	fiesta	N
nature	naturaleza	N
rod	barra	N
shoe	zapato	N
conquest	conquista	N
doodle	garabato	N
hen	gallina	N
cockatoo	cacatúa	N
elevator	ascensor	N
beach	playa	N
jaw	mandíbula	N
adversary	adversario	N
salary	salario	N
vase	florero	N
mountain	montaña	N
mallard	pato real	N
shelter	abrigo	N
reef	arrecife	N
truck	camión	N
fiction	ficción	N
strawberry	fresa	N
cup	taza	N
pond	estanque	N
secretary	secretario	N
might	poder	N
electron	electrón	N
node	nodo	N
father	padre	N
death	muerte	N
cake	pastel	N
manager	gerente	N
daisy	margarita	N
kid	niño	N
cotton	algodón	N
tree	árbol	N
butterfly	mariposa	N
turkey	pavo	N
sunshine	sol	N
marrow	médula	N
profession	profesión	N
cross	cruz	N
whisker	bigote	N
size	tamaño	N
jump	salto	N
mac	impermeable	N
reflection	reflexión	N
warrior	guerrero	N
code	código	N
work	trabajo	N
bead	talón	N
diver	buzo	N
president	presidente	N
box	caja	N
nerve	nervio	N
century	siglo	N
computer	ordenador	N
ruler	regla	N
hole	agujero	N
literature	literatura	N
harm	daño	N
zebra	cebra	N
dragonfly	libélula	N
railroad	ferrocarril	N
enemy	enemigo	N
un	Naciones Unidas	N
pipe	tubo	N
bedroom	dormitorio	N
manner	manera	N
guitar	guitarra	N
summer	verano	N
institution	institución	N
professor	profesor	N
fairy	hada	N
disk	disco	N
appointment	cita	N
buddy	amigo	N
coal	carbón	N
bean	haba	N
salad	ensalada	N
museum	museo	N
wheat	trigo	N
mud	barro	N
pet	animal favorito	N
perception	percepción	N
skating	patinaje	N
child	niño	N
company	empresa	N
village	pueblo	N
people	personas	N
seed	semilla	N
clue	pista	N
travel	viajes	N
transformer	transformador	N
thumb	pulgar	N
road	carretera	N
twig	ramita	N
tornado	tornado	N
helicopter	helicóptero	N
horse	caballo	N
underwear	ropa interior	N
brand-new	Para estrenar	N
ski	esquí	N
lemon	limón	N
conversation	conversación	N
epidemic	epidemia	N
web	web	N
hose	manguera	N
sugar	azúcar	N
construction	construcción	N
pie	pastel	N
haze	calina	N
waist	cintura	N
threat	amenaza	N
leaf	hoja	N
scenery	paisaje	N
landscape	paisaje	N
bubble	burbuja	N
income	ingresos	N
pigeon	paloma	N
gauge	calibre	N
circle	círculo	N
trip	viaje	N
gossip	chismes	N
oak	roble	N
vessel	buque	N
graveyard	cementerio	N
battle	batalla	N
argument	argumento	N
staircase	escalera	N
arithmetic	aritmética	N
situation	situación	N
steel	acero	N
herb	hierba	N
show	show	N
family	familia	N
era	era	N
wig	peluca	N
bag	bolsa	N
queen	reina	N
moon	luna	N
abdomen	abdomen	N
skyscraper	rascacielos	N
wolf	lobo	N
CD	discos compactos	N
dome	cúpula	N
chess	ajedrez	N
logo	logo	N
lingerie	lencería	N
par	par	N
album	álbum	N
athlete	atleta	N
bone	hueso	N
accident	accidente	N
balloon	globo	N
breakfast	desayuno	N
ticket	billete	N
cocktail	cóctel	N
fame	fama	N
confusion	confusión	N
verdict	veredicto	N
cousin	primo	N
note	nota	N
angle	ángulo	N
season	temporada	N
harbor	puerto	N
padlock	candado	N
limb	miembro	N
valley	valle	N
right	derecho	N
envelope	sobre	N
garbage	basura	N
pyramid	pirámide	N
information	información	N
silver	plata	N
item	ítem	N
infant	niño	N
food	comida	N
autumn	otoño	N
nut	tuerca	N
engine	motor	N
lily	lirio	N
medium	medio	N
tooth	diente	N
morning	mañana	N
smoke	humo	N
concert	concierto	N
jean	vaquero	N
movement	movimiento	N
stair	escalera	N
muscle	músculo	N
economy	economía	N
husky	perro esquimal	N
biography	biografía	N
television	televisión	N
cactus	cactus	N
whale	ballena	N
tag	etiqueta	N
carpet	alfombra	N
pig	cerdo	N
potato	patata	N
neon	neón	N
fence	cerca	N
spring	primavera	N
railway	ferrocarril	N
horn	claxon	N
wind	viento	N
bacon	tocino	N
cab	taxi	N
baby	bebé	N
building	edificio	N
day	día	N
cheek	mejilla	N
model	modelo	N
grave	tumba	N
anger	ira	N
rail	carril	N
corpse	cadáver	N
racket	raqueta	N
violin	violín	N
carbon	carbón	N
victor	Víctor	N
meter	metro	N
spine	espina	N
comfort	comodidad	N
barn	granero	N
adult	adulto	N
straw	paja	N
donkey	burro	N
spiral	espiral	N
frustration	frustración	N
station	estación	N
galaxy	galaxia	N
serpent	serpiente	N
christmas	Navidad	N
camel	camello	N
vitamin	vitamina	N
head	cabeza	N
cottage	cabaña	N
skate	patín	N
origami	origami	N
cobra	cobra	N
idea	idea	N
reptile	reptil	N
harbour	puerto	N
card	tarjeta	N
donut	buñuelo	N
outfit	equipo	N
rattle	traqueteo	N
saint	santo	N
weed	mala hierba	N
psychology	psicología	N
hall	sala	N
carriage	carro	N
office	oficina	N
crystal	cristal	N
surface	superficie	N
employer	empleador	N
shade	sombra	N
crab	cangrejo	N
tobacco	tabaco	N
zombie	zombi	N
physician	médico	N
floor	piso	N
haircut	corte de pelo	N
singer	cantante	N
clip	presilla	N
plate	placa	N
freeway	autopista	N
cutie	chica	N
gun	pistola	N
drop	caer	V
protect	proteger	V
understand	entender	V
enter	entrar	V
possess	poseer	V
predict	predecir	V
play	jugar	V
spend	pasar	V
replace	reemplazar	V
deny	negar	V
choke	ahogar	V
fail	fallar	V
drip	gotear	V
deliver	entregar	V
expand	expandir	V
read	leer	V
accomplish	lograr	V
obey	obedecer	V
comprehend	comprender	V
portray	retratar	V
realize	realizar	V
sink	hundir	V
inquire	preguntar	V
leave	dejar	V
shrink	encoger	V
get	obtener	V
keep	mantener	V
investigate	investigar	V
sign	firmar	V
cherish	apreciar	V
build	construir	V
appoint	nombrar	V
carry	llevar	V
save	guardar	V
elect	elegir	V
examine	examinar	V
fall	caer	V
hang	colgar	V
hear	oír	V
feel	sentir	V
disorganize	desorganizar	V
pursue	perseguir	V
shed	perder	V
restore	restaurar	V
enjoy	disfrutar	V
argue	argumentar	V
acquire	adquirir	V
justify	justificar	V
do	hacer	V
write	escribir	V
achieve	lograr	V
behave	comportarse	V
seem	parecer	V
forget	olvidar	V
conclude	concluir	V
walk	caminar	V
satisfy	satisfacer	V
paint	pintar	V
go	ir	V
plead	alegar	V
inform	informar	V
buy	comprar	V
sleep	dormir	V
meet	conocer	V
forgive	perdonar	V
please	complacer	V
disappear	desaparecer	V
participate	participar	V
swim	nadar	V
become	convertirse en	V
absorb	absorber	V
steal	robar	V
add	añadir	V
remind	recordar	V
prove	demostrar	V
glitter	resplandecer	V
appear	aparecer	V
find	encontrar	V
take	tomar	V
ask	hacer	V
marry	casarse	V
reduce	reducir	V
sit	sentarse	V
beg	mendigar	V
wash	lavar	V
explain	explicar	V
contemplate	contemplar	V
wander	vagar	V
allow	permitir	V
pray	orar	V
attend	asistir	V
verify	verificar	V
determine	determinar	V
grow	crecer	V
succeed	tener éxito	V
kill	matar	V
remain	permanecer	V
blur	difuminar	V
imitate	imitar	V
lose	perder	V
roam	vagar	V
multiply	multiplicar	V
learn	aprender	V
lock	bloquear	V
compare	comparar	V
eat	comer	V
borrow	pedir prestado	V
occur	ocurrir	V
try	probar	V
join	unirse	V
vanish	desaparecer	V
deserve	merecer	V
assume	asumir	V
put	poner	V
recommend	recomendar	V
discover	descubrir	V
run	ejecutar	V
think	pensar	V
create	crear	V
proclaim	proclamar	V
come	venir	V
encourage	fomentar	V
live	vivir	V
agree	acordar	V
speak	hablar	V
differ	diferir de	V
locate	localizar	V
engage	contratar	V
want	querer	V
communicate	comunicar	V
ignore	pasar por alto	V
accept	aceptar	V
quit	dejar	V
discourage	desalentar	V
declare	declarar	V
evaluate	evaluar	V
dominate	dominar	V
win	ganar	V
advise	asesorar	V
withdraw	retirar	V
make	hacer	V
give	dar	V
divide	dividir	V
overcome	superar	V
analyze	analizar	V
imagine	imaginar	V
require	exigir	V
discuss	discutir	V
inspect	inspeccionar	V
acknowledge	reconocer	V
obtain	obtener	V
stand	estar	V
cooperate	cooperar	V
hold	mantener	V
destroy	destruir	V
handle	manejar	V
begin	comenzar	V
abandon	abandonar	V
earn	ganar	V
greet	saludar	V
complain	quejarse	V
listen	escuchar	V
rationalize	racionalizar	V
avoid	evitar	V
originate	originar	V
receive	recibir	V
pretend	fingir	V
explore	explorar	V
sell	vender	V
stop	detener	V
reject	rechazar	V
relax	relajarse	V
persuade	persuadir	V
lick	lamer	V
bring	traer	V
sing	cantar	V
fly	volar	V
retain	conservar	V
arrive	llegar	V
say	decir	V
organize	organizar	V
choose	elegir	V
lend	prestar	V
breathe	respirar	V
entertain	entretener	V
burn	quemar	V
knit	tejer	V
draw	dibujar	V
clarify	aclarar	V
post	enviar	V
owe	deber	V
attach	adjuntar	V
know	saber	V
arrange	organizar	V
bear	soportar	V
curl	enroscarse	V
decide	decidir	V
happen	suceder	V
construct	construir	V
notify	notificar	V
believe	creer	V
defend	defender	V
gather	reunir	V
announce	anunciar	V
send	enviar	V
collect	recoger	V
