unnecessary	ненужный	A
insane	безумный	A
dirty	грязный	A
obvious	очевидный	A
scarce	дефицитный	A
vintage	марочный	A
rapid	быстрый	A
ashamed	пристыженный	A
orange	оранжевый	A
happy	счастливый	A
black	черный	A
normal	нормальный	A
pink	розовый	A
graphic	графический	A
hot	жаркий	A
important	важный	A
friendly	дружественный	A
dead	мертвый	A
bad	плохой	A
outdoor	внешний	A
narrow	узкий	A
crazy	сумасшедший	A
dreary	тоскливый	A
great	большой	A
anxious	тревожный	A
abstract	абстрактный	A
cruel	жестокий	A
difficult	трудный	A
clever	умный	A
tall	высокий	A
broad	широкий	A
female	женский	A
tropical	тропический	A
different	другой	A
foolish	глупый	A
underwater	подводный	A
sunny	солнечный	A
glad	радостный	A
simple	простой	A
bold	смелый	A
sharp	резкий	A
sure	верный	A
restless	беспокойный	A
blue	синий	A
intelligent	умный	A
brown	коричневый	A
mad	безумный	A
smart	умный	A
exotic	экзотический	A
key	ключевой	A
cute	милый	A
military	военный	A
frigid	холодный	A
large	большой	A
white	белый	A
nice	хороший	A
dull	тусклый	A
yellow	желтый	A
old	старый	A
underground	подземный	A
dumb	немой	A
funny	смешной	A
sweet	сладкий	A
sexy	сексуальный	A
wet	мокрый	A
industrial	промышленный	A
fast	быстрый	A
afraid	испуганный	A
rough	грубый	A
feline	кошачий	A
sly	хитрый	A
wild	дикий	A
laden	груженый	A
modest	скромный	A
ancient	древний	A
tough	жесткий	A
illegal	незаконный	A
easy	легкий	A
immoral	аморальный	A
urban	городской	A
wonderful	замечательный	A
young	молодой	A
cheerful	веселый	A
strong	сильный	A
beautiful	прекрасный	A
crucial	решающий	A
unhappy	несчастный	A
proud	гордый	A
dense	плотный	A
weird	странный	A
wide	широкий	A
blonde	светлый	A
fragile	хрупкий	A
pregnant	беременная	A
uniform	единый	A
quick	быстрый	A
bright	яркий	A
violent	насильственный	A
terrible	страшный	A
recent	недавний	A
essential	существенный	A
canine	собачий	A
honest	честный	A
rare	редкий	A
stupid	глупый	A
sick	больной	A
square	квадратный	A
flexible	гибкий	A
inexpensive	недорогой	A
modern	современный	A
childish	детский	A
harsh	резкий	A
heavy	тяжелый	A
misty	туманный	A
grey	серый	A
proper	надлежащий	A
nude	голый	A
tiny	крошечный	A
cold	холодный	A
necessary	необходимый	A
confident	уверенный	A
colorful	красочный	A
red	красный	A
odd	странный	A
cheap	дешевый	A
short	короткий	A
small	небольшой	A
hard	жесткий	A
certain	определенный	A
strange	странный	A
fresh	свежий	A
concrete	конкретный	A
new	новый	A
guilty	виновный	A
noticeable	заметный	A
long	длинный	A
green	зеленый	A
angry	сердитый	A
polite	вежливый	A
sad	печальный	A
impatient	нетерпеливый	A
frozen	замороженный	A
formal	формальный	A
bizarre	странный	A
generous	щедрый	A
big	большой	A
rusty	ржавый	A
huge	огромный	A
purple	фиолетовый	A
dark	темный	A
aerial	воздушный	A
awful	ужасный	A
terrific	потрясающий	A
downtown	в центре города	A
miniature	миниатюрный	A
apparent	очевидный	A
ceramic	керамический	A
delightful	восхитительный	A
elastic	эластичный	A
lighthouse	маяк	N
universe	вселенная	N
whiskey	виски	N
essay	эссе	N
belt	ремень	N
university	университет	N
colt	жеребенок	N
pantyhose	колготки	N
commonwealth	содружество	N
lighting	освещение	N
cube	куб	N
duck	утка	N
pin	штифт	N
insight	понимание	N
discussion	обсуждение	N
rainbow	радуга	N
prestige	престиж	N
trail	след	N
daffodil	бледно-желтый нарцис	N
tongue	язык	N
porch	крыльцо	N
choice	выбор	N
lover	любовник	N
cowboy	ковбой	N
nephew	племянник	N
unicorn	единорог	N
fish	рыба	N
sheep	овца	N
island	остров	N
finger	палец	N
captain	капитан	N
grape	виноград	N
magazine	журнал	N
totem	тотем	N
locomotive	локомотив	N
dude	чувак	N
belly	живот	N
swimsuit	женский купальник	N
penguin	пингвин	N
weather	погода	N
mill	мельница	N
grief	горе	N
diet	диета	N
emotion	эмоция	N
cop	полицейский	N
intelligence	интеллект	N
catastrophe	катастрофа	N
rattlesnake	гремучая змея	N
date	дата	N
molecule	молекула	N
telephone	телефон	N
jellyfish	медуза	N
apple	яблоко	N
sticker	наклейка	N
rabbit	кролик	N
plane	самолет	N
comet	комета	N
banana	банан	N
light	свет	N
gin	джин	N
break	перерыв	N
music	музыка	N
painting	живопись	N
shepherd	овчарка	N
clothes	одежда	N
author	автор	N
scratch	царапина	N
clock	часы	N
graph	график	N
hut	хижина	N
destruction	разрушение	N
transition	переход	N
sequence	последовательность	N
bell	колокол	N
mirror	зеркало	N
crack	трещина	N
sense	смысл	N
cage	клетка	N
snake	змея	N
lock	замок	N
organ	орган	N
bush	втулка	N
instructor	инструктор	N
newspaper	газета	N
hallway	прихожая	N
meat	мясо	N
escalator	эскалатор	N
graffito	сграффито	N
hero	герой	N
proof	доказательство	N
game	игра	N
incident	инцидент	N
root	корень	N
priest	священник	N
ethidium	этидия	N
place	место	N
area	площадь	N
rust	ржавчина	N
key	ключ	N
drawer	выдвижной ящик	N
ipod	Сделать ставку	N
reading	считывание	N
money	деньги	N
aisle	проход	N
arch	арка	N
map	карта	N
camp	лагерь	N
object	объект	N
princess	принцесса	N
devil	дьявол	N
jail	тюрьма	N
companion	компаньон	N
middle	середина	N
bias	смещение	N
sentry	часовой	N
planet	планета	N
industry	промышленность	N
decoration	украшение	N
bat	летучая мышь	N
gravestone	надгробный камень	N
skin	кожа	N
element	элемент	N
rabbi	раввин	N
nucleus	ядро	N
mob	толпа	N
god	бог	N
gel	гель	N
step	шаг	N
sailor	моряк	N
device	устройство	N
style	стиль	N
west	запад	N
actor	актер	N
goal	цель	N
bull	бык	N
machine	машина	N
scientist	ученый	N
flood	поток	N
alcohol	алкоголь	N
fisherman	рыбак	N
turtle	черепаха	N
phoenix	феникс	N
flour	мука	N
champion	чемпион	N
flame	пламя	N
peel	кожура	N
fever	лихорадка	N
crib	детская кроватка	N
arrow	стрелка	N
age	возраст	N
winter	зима	N
temper	характер	N
beauty	красота	N
display	дисплей	N
sea	море	N
anchor	якорь	N
story	история	N
curve	кривая	N
sauce	соус	N
film	фильм	N
soul	душа	N
mammal	млекопитающее	N
morphism	морфизм	N
depth	глубина	N
petal	лепесток	N
jazz	джаз	N
blackamoor	арап	N
squirrel	белка	N
quantum	квант	N
hound	собака	N
bakery	пекарня	N
sunflower	подсолнечник	N
goo	сентиментальщина	N
garden	сад	N
iron	железо	N
chopper	вертолет	N
nest	гнездо	N
sport	спорт	N
shirt	рубашка	N
bud	бутон	N
corporation	корпорация	N
river	река	N
poodle	пудель	N
pizza	пицца	N
thing	вещь	N
sunlight	солнечный свет	N
sunglasses	темные очки	N
entity	объект	N
endurance	выносливость	N
cloud	облако	N
goose	гусь	N
metro	метро	N
bucket	ведро	N
seashore	морское побережье	N
night	ночь	N
alley	аллея	N
asphalt	асфальт	N
event	событие	N
border	граница	N
canyon	каньон	N
koala	коала	N
figure	рисунок	N
snowman	снеговик	N
pug	мопс	N
wine	вино	N
fungus	гриб	N
boundary	граница	N
animal	животное	N
sinner	грешник	N
caterpillar	гусеница	N
brick	кирпич	N
hockey	хоккей	N
hip	бедро	N
article	статья	N
dirt	грязь	N
distraction	отвлечение	N
basketball	баскетбол	N
news	новости	N
sword	меч	N
sickness	болезнь	N
jar	банка	N
dolphin	дельфин	N
knight	рыцарь	N
calf	теленок	N
tulip	тюльпан	N
sheriff	шериф	N
cookie	печенье	N
mood	настроение	N
wool	шерсть	N
toddler	ползунок	N
football	футбол	N
wisdom	мудрость	N
advertisement	реклама	N
damsel	девица	N
door	дверь	N
ghost	призрак	N
lion	лев	N
candy	конфеты	N
punk	панк	N
mouse	мышь	N
ford	брод	N
victory	победа	N
jaguar	ягуар	N
order	заказ	N
slowdown	замедление	N
partition	раздел	N
celebrity	знаменитость	N
helium	гелий	N
moment	момент	N
raspberry	малина	N
theme	тема	N
hat	шляпа	N
course	курс	N
flight	рейс	N
cucumber	огурец	N
skirt	юбка	N
moose	американский лось	N
belief	вера	N
oil	масло	N
diffraction	дифракция	N
seat	сиденье	N
ob	О.Б.	N
tear	слеза	N
orb	шар	N
baracudda	барракуда	N
witch	ведьма	N
page	страница	N
region	область	N
stamp	марка	N
ball	мяч	N
house	дом	N
happiness	счастье	N
bed	постель	N
topic	тема	N
cone	конус	N
target	цель	N
pre	до	N
leather	кожа	N
wedding	свадьба	N
view	вид	N
college	колледж	N
sample	образец	N
landmark	ориентир	N
tunnel	туннель	N
tax	налог	N
round	раунд	N
dream	мечта	N
denial	отказ	N
fraud	мошенничество	N
brow	лоб	N
prey	добыча	N
helper	помощник	N
dinner	ужин	N
sidewalk	тротуар	N
poster	плакат	N
roof	крыша	N
vinegar	уксус	N
table	стол	N
bike	велосипед	N
dictionary	словарь	N
vinyl	винил	N
puppy	щенок	N
surf	прибой	N
can	баллончик	N
path	путь	N
spoon	ложка	N
flu	грипп	N
presence	присутствие	N
dessert	десерт	N
art	искусство	N
ice	лед	N
airplane	самолет	N
desert	пустыня	N
chain	цепь	N
interest	интерес	N
droplet	капелька	N
magnitude	величина	N
battery	аккумулятор	N
zoo	зоопарк	N
bus	автобус	N
illusion	иллюзия	N
skateboard	скейтборд	N
poppy	мак	N
ability	способность	N
chocolate	шоколад	N
second	секунда	N
goat	козел	N
mermaid	русалка	N
shop	магазин	N
deck	палуба	N
hostility	враждебность	N
sushi	суши	N
castle	замок	N
king	царь	N
man	человек	N
canal	канал	N
cigar	сигара	N
lung	легкое	N
vehicle	автомобиль	N
opinion	мнение	N
statue	статуя	N
smoking	курение	N
mosque	мечеть	N
hair	волосы	N
side	сторона	N
window	окно	N
mouth	рот	N
diamond	бриллиант	N
ox	бык	N
pattern	узор	N
chair	стул	N
dandelion	одуванчик	N
vision	видение	N
polyester	полиэстер	N
eye	глаз	N
wife	жена	N
misery	страдание	N
pub	паб	N
bloom	цветение	N
gull	чайка	N
kitty	котенок	N
definition	определение	N
chipmunk	бурундук	N
top	верх	N
pilot	пилот	N
suds	мыльная пена	N
cell	ячейка	N
tombstone	надгробная плита	N
person	человек	N
jacket	куртка	N
shadow	тень	N
monkey	обезьяна	N
attention	внимание	N
ledge	выступ	N
panda	панда	N
pollution	загрязнение	N
ladder	лестница	N
city	город	N
cheese	сыр	N
photographer	фотограф	N
chief	начальник	N
pumpkin	тыква	N
sandwich	бутерброд	N
doctor	доктор	N
impression	впечатление	N
non	не	N
employee	работник	N
chapel	часовня	N
linen	белье	N
boy	мальчик	N
casino	казино	N
actress	актриса	N
wound	рана	N
stuff	материал	N
beetle	жук	N
cafe	кафе	N
pot	горшок	N
burial	захоронение	N
foot	нога	N
cannon	пушка	N
criticism	критика	N
product	продукт	N
corridor	коридор	N
sun	солнце	N
pair	пара	N
composer	композитор	N
marble	мрамор	N
noodle	балда	N
circumstance	обстоятельство	N
character	характер	N
color	цвет	N
fur	мех	N
monument	памятник	N
inn	трактир	N
charcoal	уголь	N
lamp	лампа	N
TV	телевизор	N
camera	камера	N
self	собственная личность	N
library	библиотека	N
interior	интерьер	N
diner	обедающий	N
bird	птица	N
texture	текстура	N
triumph	триумф	N
pride	гордость	N
slide	слайд	N
horizon	горизонт	N
egg	яйцо	N
bishop	епископ	N
craft	ремесло	N
nose	нос	N
stomach	желудок	N
attorney	прокурор	N
phenomenon	явление	N
mug	кружка	N
grade	оценка	N
frame	рамка	N
passion	страсть	N
concept	концепция	N
elephant	слон	N
heroine	героиня	N
owl	сова	N
nation	нация	N
storm	шторм	N
number	номер	N
bikini	бикини	N
leader	лидер	N
poverty	бедность	N
tile	плитка	N
friend	друг	N
car	автомобиль	N
creator	автор	N
cord	шнур	N
choir	хор	N
motorcycle	мотоцикл	N
log	журнал	N
beef	говядина	N
guardian	опекун	N
spirit	дух	N
collection	коллекция	N
colour	цвет	N
supper	ужин	N
guy	парень	N
woman	женщина	N
intuition	интуиция	N
lake	озеро	N
fountain	фонтан	N
flag	флаг	N
celebration	празднование	N
ballad	баллада	N
pier	пирс	N
vine	лоза	N
line	линия	N
evening	вечер	N
surfer	серфер	N
atmosphere	атмосфера	N
bulb	лампа	N
shoulder	плечо	N
rice	рис	N
population	население	N
rally	ралли	N
steak	стейк	N
murder	убийство	N
brain	мозг	N
aggression	агрессия	N
cross-section	поперечное сечение	N
lizard	ящерица	N
shame	стыд	N
costume	костюм	N
mask	маска	N
hamburger	гамбургер	N
com	ком	N
aunt	тетя	N
swimming	плавание	N
attitude	отношение	N
peace	мир	N
knee	колено	N
skeleton	скелет	N
legion	легион	N
aquarium	аквариум	N
cow	корова	N
soup	суп	N
rectangle	прямоугольник	N
restaurant	ресторан	N
daughter	дочь	N
election	выборы	N
absence	отсутствие	N
meteor	метеор	N
iceberg	айсберг	N
tumor	опухоль	N
job	работа	N
kite	коршун	N
printer	принтер	N
handwriting	почерк	N
match	матч	N
factory	фабрика	N
coffee	кофе	N
anatomy	анатомия	N
cherry	вишня	N
meal	еда	N
cloth	ткань	N
dentist	дантист	N
farm	ферма	N
equation	уравнение	N
sky	небо	N
dawn	рассвет	N
berry	ягода	N
fury	ярость	N
science	наука	N
dad	папа	N
pepper	перец	N
state	состояние	N
dinosaur	динозавр	N
melody	мелодия	N
chicken	курица	N
lawyer	адвокат	N
assignment	назначение	N
coast	побережье	N
van	фургон	N
teacher	учитель	N
glove	перчатка	N
ceremony	церемония	N
hummingbird	колибри	N
picture	рисунок	N
spider	паук	N
management	управление	N
stadium	стадион	N
prisoner	заключенный	N
fruit	фрукты	N
pelican	пеликан	N
teeth	зубы	N
men	люди	N
career	карьера	N
capital	капитал	N
ruin	руины	N
bench	верстак	N
journal	журнал	N
aircraft	самолет	N
business	бизнес	N
parrot	попугай	N
pitcher	кувшин	N
wire	провод	N
racing	разгон	N
country	страна	N
interval	интервал	N
image	образ	N
fiend	злодей	N
groom	жених	N
south	юг	N
sorrow	печаль	N
foliage	листва	N
uncle	дядя	N
song	песня	N
continent	континент	N
metal	металл	N
band	полоса	N
stream	поток	N
language	язык	N
goddess	богиня	N
grass	трава	N
feather	перо	N
anarchy	анархия	N
tattoo	тату	N
dog	собака	N
signature	подпись	N
couple	пара	N
snow	снег	N
motel	мотель	N
palm	ладонь	N
carnival	карнавал	N
port	порт	N
bottle	бутылка	N
chest	грудь	N
sketch	эскиз	N
fun	забава	N
design	дизайн	N
nun	монахиня	N
fraternity	братство	N
sportsman	спортсмен	N
community	сообщество	N
dance	танец	N
task	задача	N
smile	улыбка	N
apartment	квартира	N
letter	письмо	N
maple	клен	N
elbow	локоть	N
officer	офицер	N
shark	акула	N
bread	хлеб	N
shopping	поход по магазинам	N
architecture	архитектура	N
life	жизнь	N
blossom	цветок	N
gravesite	могилы	N
face	лицо	N
crow	ворона	N
sofa	диван	N
photo	фото	N
stencil	трафарет	N
protest	протест	N
cattle	крупный рогатый скот	N
blanket	одеяло	N
orchid	орхидея	N
swing	качели	N
wasp	оса	N
water	воды	N
ceiling	потолок	N
jet	струя	N
mare	кобыла	N
teenager	подросток	N
mustard	горчица	N
exit	выход	N
beast	зверь	N
pseudo-scorpion	псевдо-скорпион	N
hill	холм	N
lawn	газон	N
hospital	больница	N
motor	двигатель	N
partner	партнер	N
kiss	поцелуй	N
movie	кино	N
kitten	котенок	N
store	магазин	N
hysteria	истерия	N
amphibian	амфибия	N
desk	стол	N
throat	горло	N
liver	печень	N
doll	кукла	N
librarian	библиотекарь	N
lego	конструктор Лего	N
mannequin	манекен	N
seal	печать	N
memorial	мемориал	N
menu	меню	N
tragedy	трагедия	N
skyline	горизонт	N
salt	соль	N
leg	нога	N
race	раса	N
tail	хвост	N
yard	двор	N
ankle	щиколотка	N
plenty	множество	N
noise	шум	N
deer	олень	N
sphere	сфера	N
danger	опасность	N
grid	сетка	N
shell	оболочка	N
terrier	терьер	N
body	тело	N
tower	башня	N
deity	божество	N
sailing	парусный спорт	N
surgery	хирургия	N
stag	холостяцкая вечеринка	N
cigarette	сигарета	N
rock	рок	N
week	неделя	N
auto	автомобиль	N
guest	гость	N
winner	победитель	N
cemetery	кладбище	N
field	поле	N
lens	объектив	N
lamb	ягненок	N
violet	фиалка	N
carrot	морковь	N
seagull	чайка	N
society	общество	N
milk	молоко	N
shore	побережье	N
indent	отступ	N
chaos	хаос	N
tea	чай	N
ripple	рябь	N
piano	пианино	N
organization	организация	N
illness	болезнь	N
rat	крыса	N
nail	гвоздь	N
pole	полюс	N
tv	телевизор	N
pod	стручок	N
cheerleader	капитан болельщиков	N
room	комната	N
sin	грех	N
eagle	орел	N
trial	суд	N
lady	леди	N
mist	туман	N
difficulty	трудность	N
hawk	ястреб	N
wave	волна	N
butter	масло	N
wealth	богатство	N
necklace	ожерелье	N
soldier	солдат	N
purse	кошелек	N
wagon	фургон	N
fraser	фрейзер	N
sunset	закат	N
festival	фестиваль	N
cellar	погреб	N
inch	дюйм	N
musician	музыкант	N
sweater	свитер	N
biology	биология	N
weekend	уик-энд	N
quest	поиски	N
army	армия	N
tram	трамвай	N
valentine	возлюбленный	N
orchestra	оркестр	N
competence	компетентность	N
slice	ломтик	N
palace	дворец	N
santa	Санта	N
stocking	чулок	N
abundance	изобилие	N
sock	носок	N
defect	дефект	N
administration	администрация	N
skill	умение	N
stork	аист	N
tomato	помидор	N
edge	край	N
drizzle	изморось	N
blade	лезвие	N
bridge	мост	N
bug	жук	N
demolition	снос	N
bicycle	велосипед	N
monk	монах	N
umbrella	зонтик	N
clown	клоун	N
folder	папка	N
rebel	мятежник	N
taxi	такси	N
sign	знак	N
bottom	дно	N
dollar	доллар	N
worker	работник	N
safety	безопасность	N
writer	писатель	N
maker	создатель	N
ivy	плющ	N
giraffe	жирафа	N
robot	робот	N
mayor	мэр	N
temple	храм	N
puppet	марионетка	N
male	мужчина	N
chemistry	химия	N
mom	мама	N
artist	художник	N
ray	луч	N
ant	муравей	N
exhibition	выставка	N
pregnancy	беременность	N
fee	вознаграждение	N
communication	связь	N
patio	патио	N
ocean	океан	N
quilt	стеганое одеяло	N
limousine	лимузин	N
dress	платье	N
orthodontist	ортодонт	N
pillow	подушка	N
stud	шпилька	N
corner	угол	N
fact	факт	N
panorama	панорама	N
cancer	рак	N
bee	пчела	N
particle	частица	N
brother	брат	N
photograph	фотография	N
makeup	макияж	N
bunny	кролик	N
faun	фавн	N
dew	роса	N
school	школа	N
badge	значок	N
parking	стоянка	N
paw	лапа	N
destination	пункт назначения	N
bride	невеста	N
skull	череп	N
cheetah	гепард	N
lab	лаборатория	N
wing	крыло	N
plump	тяжелое падение	N
paper	документ	N
vacation	отпуск	N
cream	крем	N
heart	сердце	N
strength	сила	N
cathedral	собор	N
joy	радость	N
segment	сегмент	N
love	любовь	N
collar	воротник	N
drug	лекарство	N
crucifix	распятие	N
toilet	туалет	N
wizard	волшебник	N
knife	нож	N
chick	цыпленок	N
sub	подводная лодка	N
teddy	Тедди	N
market	рынок	N
phrase	фраза	N
reader	читатель	N
colonel	полковник	N
boxer	боксер	N
scream	вопль	N
navy	морское ведомство	N
fetus	плод	N
creature	создание	N
dancer	танцор	N
girl	девушка	N
nurse	медсестра	N
pool	бассейн	N
juice	сок	N
wheel	колесо	N
lantern	фонарь	N
liquor	ликер	N
hamster	хомяк	N
drive	драйв	N
furniture	мебель	N
neck	шея	N
scooter	скутер	N
rain	дождь	N
sculpture	скульптура	N
lip	губа	N
decade	десятилетие	N
backdrop	задник	N
footprint	след	N
copper	медь	N
astronaut	астронавт	N
basket	корзина	N
swastika	свастика	N
postcard	открытка	N
year	год	N
air	воздух	N
maid	дева	N
bath	ванна	N
tin	олово	N
pupil	ученик	N
bullet	пуля	N
emergency	авария	N
triangle	треугольник	N
toe	палец	N
cooking	варка	N
rocket	ракета	N
club	клуб	N
condition	состояние	N
cereal	хлебный злак	N
ink	чернила	N
barracuda	барракуда	N
calendar	календарь	N
birthday	день рождения	N
bomb	бомба	N
opponent	оппонент	N
orange	апельсин	N
august	августейший	N
gentleman	джентльмен	N
rodent	грызун	N
crown	корона	N
zone	зона	N
keyboard	клавиатура	N
gate	ворота	N
flamingo	фламинго	N
street	улица	N
dragon	дракон	N
pearl	жемчуг	N
cabin	кабина	N
church	церковь	N
mechanic	механик	N
disc	диск	N
wood	дерево	N
fire	огонь	N
payment	оплата	N
disease	болезнь	N
photography	фотография	N
windmill	ветряная мельница	N
garage	гараж	N
party	группа	N
arm	рука	N
action	действие	N
fantasy	фантастика	N
dusk	сумерки	N
awareness	осознание	N
candidate	кандидат	N
silhouette	силуэт	N
phone	телефон	N
stone	камень	N
swan	лебедь	N
journey	путешествие	N
redhead	рыжеволосый человек	N
agreement	соглашение	N
baseball	бейсбол	N
confession	признание	N
glass	стекло	N
traffic	движение	N
smiley	смайлик	N
minister	министр	N
vein	вена	N
steeple	шпиль	N
forest	лес	N
demon	демон	N
brandy	бренди	N
firework	фейерверк	N
time	время	N
rhythm	ритм	N
quote	цитата	N
volcano	вулкан	N
lunch	обед	N
fishing	рыбалка	N
marijuana	марихуана	N
cardboard	картон	N
book	книга	N
champagne	шампанское	N
appliance	прибор	N
passport	паспорт	N
gasoline	бензин	N
police	полиция	N
world	мир	N
luck	удача	N
crowd	толпа	N
bay	залив	N
formula	формула	N
cavern	пещера	N
ear	ухо	N
way	способ	N
paragraph	пункт	N
driver	драйвер	N
parade	парад	N
beverage	напиток	N
loop	петля	N
drum	барабан	N
hand	рука	N
insect	насекомое	N
culture	разведение	N
ad	объявление	N
coin	монета	N
document	документ	N
theft	кража	N
kitchen	кухня	N
capability	возможности	N
container	контейнер	N
waterfall	водопад	N
aviation	авиация	N
squad	отряд	N
explosion	взрыв	N
stripe	полоса	N
rose	роза	N
cradle	колыбель	N
ship	корабль	N
home	дом	N
iris	ирис	N
jewelry	ювелирные изделия	N
minute	минута	N
bar	бар	N
elegance	элегантность	N
button	кнопка	N
toy	игрушка	N
moss	мох	N
frost	мороз	N
rope	веревка	N
flesh	плоть	N
train	поезд	N
vertex	вершина	N
scene	сцена	N
bunch	пучок	N
illustration	иллюстрация	N
artwork	произведение искусства	N
parent	родитель	N
pleasure	удовольствие	N
town	город	N
flower	цветок	N
gut	кишка	N
star	звезда	N
hurricane	ураган	N
month	месяц	N
trick	трюк	N
kidney	почка	N
wall	стена	N
bracelet	браслет	N
despair	отчаяние	N
crime	преступление	N
hotel	отель	N
collage	коллаж	N
couch	диван	N
swamp	болото	N
sunrise	восход солнца	N
instrument	инструмент	N
booth	кабина	N
cliff	утес	N
monster	монстр	N
mink	норка	N
con	жулик	N
symbol	символ	N
cent	цент	N
globe	глобус	N
robbery	ограбление	N
point	точка	N
peacock	павлин	N
track	трек	N
tiger	тигр	N
gymnastics	гимнастика	N
section	раздел	N
class	сорт	N
wrist	запястье	N
aluminum	алюминий	N
horseman	всадник	N
reality	реальность	N
fashion	мода	N
son	сын	N
mural	фреска	N
infection	инфекция	N
frog	лягушка	N
mushroom	гриб	N
beard	борода	N
plough	плуг	N
fingerprint	отпечаток пальца	N
tank	бак	N
bible	библия	N
fog	туман	N
puddle	лужа	N
fox	лиса	N
beer	пиво	N
airport	аэропорт	N
pact	пакт	N
closet	чулан	N
husband	муж	N
patient	пациент	N
classroom	классная комната	N
subway	метро	N
plant	завод	N
curtain	занавес	N
boat	лодка	N
scheme	схема	N
text	текст	N
bathroom	ванная комната	N
honey	мед	N
stewardess	стюардесса	N
splash	всплеск	N
cat	кошка	N
branch	филиал	N
theory	теория	N
park	парк	N
lifetime	продолжительность жизни	N
mother	мать	N
doorway	дверной проем	N
homomorphism	гомоморфизм	N
logic	логика	N
student	студент	N
coat	пальто	N
neighborhood	окрестности	N
justice	справедливость	N
automobile	автомобиль	N
activity	активность	N
north	север	N
gold	золото	N
kangaroo	кенгуру	N
haven	убежище	N
exoplanet	экзопланета	N
angel	ангел	N
alligator	крокодил	N
portrait	портрет	N
dye	краситель	N
blood	кровь	N
organisation	организация	N
value	значение	N
billboard	рекламный щит	N
engagement	зацепление	N
economist	экономист	N
bowl	чаша	N
crane	кран	N
law	закон	N
chapter	глава	N
banker	банкир	N
boot	ботинок	N
archbishop	архиепископ	N
burger	бутерброд	N
politician	политик	N
gorilla	горилла	N
oscilloscope	осциллограф	N
boardwalk	дощатый настил	N
ignorance	невежество	N
pencil	карандаш	N
crochet	вязальный крючок	N
theatre	театр	N
stitch	стежка	N
confidence	уверенность	N
word	слово	N
atom	атом	N
sand	песок	N
pain	боль	N
hymn	гимн	N
effort	усилие	N
fabric	ткань	N
prince	князь	N
pebble	галька	N
brand	тавро	N
timber	лесоматериалы	N
fist	кулак	N
agony	агония	N
highway	шоссе	N
violation	нарушение	N
candle	свеча	N
holiday	праздник	N
nature	природа	N
rod	стержень	N
shoe	ботинок	N
conquest	завоевание	N
doodle	болван	N
hen	курица	N
cockatoo	какаду	N
elevator	лифт	N
beach	пляж	N
jaw	зажим	N
adversary	противник	N
salary	зарплата	N
vase	ваза	N
mountain	гора	N
mallard	кряква	N
shelter	убежище	N
reef	риф	N
truck	грузовик	N
fiction	вымысел	N
strawberry	клубника	N
cup	чашка	N
pond	пруд	N
secretary	секретарь	N
might	мощь	N
electron	электрон	N
node	узел	N
father	отец	N
death	смерть	N
cake	торт	N
manager	менеджер	N
daisy	маргаритка	N
kid	ребенок	N
cotton	хлопок	N
tree	дерево	N
butterfly	бабочка	N
turkey	индейка	N
sunshine	солнечный свет	N
marrow	мозг	N
profession	профессия	N
cross	крест	N
whisker	усы	N
size	размер	N
jump	прыжок	N
mac	макинтош	N
reflection	отражение	N
warrior	воин	N
code	код	N
work	работа	N
bead	шарик	N
diver	водолаз	N
president	президент	N
box	коробка	N
nerve	нерв	N
century	век	N
computer	компьютер	N
ruler	правитель	N
hole	отверстие	N
literature	литература	N
harm	вред	N
zebra	зебра	N
dragonfly	стрекоза	N
railroad	железная дорога	N
enemy	враг	N
un	ООН	N
pipe	труба	N
bedroom	спальня	N
manner	способ	N
guitar	гитара	N
summer	лето	N
institution	заведение	N
professor	профессор	N
fairy	фея	N
disk	диск	N
appointment	назначение	N
buddy	приятель	N
coal	уголь	N
bean	фасоль	N
salad	салат	N
museum	музей	N
wheat	пшеница	N
mud	грязи	N
pet	домашнее животное	N
perception	восприятие	N
skating	катание на коньках	N
child	ребенок	N
company	компания	N
village	деревня	N
people	люди	N
seed	семя	N
clue	ключ	N
travel	путешествие	N
transformer	трансформатор	N
thumb	большой палец руки	N
road	дорога	N
twig	веточка	N
tornado	торнадо	N
helicopter	вертолет	N
horse	лошадь	N
underwear	нижнее белье	N
brand-new	совершенно новый	N
ski	лыжа	N
lemon	лимон	N
conversation	разговор	N
epidemic	эпидемия	N
web	сеть	N
hose	шланг	N
sugar	сахар	N
construction	строительство	N
pie	пирог	N
haze	дымка	N
waist	талия	N
threat	угроза	N
leaf	лист	N
scenery	пейзаж	N
landscape	пейзаж	N
bubble	пузырь	N
income	доход	N
pigeon	голубь	N
gauge	калибр	N
circle	круг	N
trip	поездка	N
gossip	сплетни	N
oak	дуб	N
vessel	судно	N
graveyard	кладбище	N
battle	бой	N
argument	аргумент	N
staircase	лестница	N
arithmetic	арифметика	N
situation	ситуация	N
steel	сталь	N
herb	трава	N
show	шоу	N
family	семья	N
era	эра	N
wig	парик	N
bag	мешок	N
queen	королева	N
moon	луна	N
abdomen	живот	N
skyscraper	небоскреб	N
wolf	волк	N
CD	CD	N
dome	купол	N
chess	шахматы	N
logo	фирменный или товарный знак	N
lingerie	дамское белье	N
par	паритет	N
album	альбом	N
athlete	спортсмен	N
bone	кость	N
accident	авария	N
balloon	воздушный шар	N
breakfast	завтрак	N
ticket	билет	N
cocktail	коктейль	N
fame	известность	N
confusion	путаница	N
verdict	вердикт	N
cousin	двоюродный брат	N
note	внимание	N
angle	угол	N
season	сезон	N
harbor	гавань	N
padlock	висячий замок	N
limb	конечность	N
valley	долина	N
right	право	N
envelope	конверт	N
garbage	мусор	N
pyramid	пирамида	N
information	информация	N
silver	серебро	N
item	пункт	N
infant	младенец	N
food	еда	N
autumn	осень	N
nut	гайка	N
engine	двигатель	N
lily	лилия	N
medium	среда	N
tooth	зуб	N
morning	утро	N
smoke	дым	N
concert	концерт	N
jean	джинсовая ткань	N
movement	движение	N
stair	ступенька	N
muscle	мышца	N
economy	экономика	N
husky	здоровяк	N
biography	биография	N
television	телевидение	N
cactus	кактус	N
whale	кит	N
tag	бирка	N
carpet	ковер	N
pig	свинья	N
potato	картофель	N
neon	неон	N
fence	забор	N
spring	весна	N
railway	железная дорога	N
horn	рог	N
wind	ветер	N
bacon	бекон	N
cab	такси	N
baby	ребенок	N
building	здание	N
day	день	N
cheek	щека	N
model	модель	N
grave	могила	N
anger	гнев	N
rail	рельс	N
corpse	труп	N
racket	ракетка	N
violin	скрипка	N
carbon	углерод	N
victor	победитель	N
meter	метр	N
spine	позвоночник	N
comfort	комфорт	N
barn	сарай	N
adult	взрослый человек	N
straw	солома	N
donkey	осел	N
spiral	спираль	N
frustration	разочарование	N
station	станция	N
galaxy	галактика	N
serpent	змея	N
christmas	рождество	N
camel	верблюд	N
vitamin	витамин	N
head	глава	N
cottage	коттедж	N
skate	конек	N
origami	оригами	N
cobra	кобра	N
idea	идея	N
reptile	рептилия	N
harbour	гавань	N
card	карты	N
donut	пончик	N
outfit	снаряжение	N
rattle	погремушка	N
saint	святой	N
weed	сорняк	N
psychology	психология	N
hall	зала	N
carriage	перевозка	N
office	офис	N
crystal	кристалл	N
surface	поверхность	N
employer	работодатель	N
shade	оттенок	N
crab	краб	N
tobacco	табак	N
zombie	зомби	N
physician	врач	N
floor	этаж	N
haircut	стрижка	N
singer	певец	N
clip	клип	N
plate	тарелка	N
freeway	Автострада	N
cutie	милашка	N
gun	пистолет	N
drop	падать	V
protect	защищать	V
understand	понять	V
enter	вводить	V
possess	обладать	V
predict	предсказывать	V
play	играть	V
spend	тратить	V
replace	заменять	V
deny	отрицать	V
choke	душить	V
fail	терпеть неудачу	V
drip	капать	V
deliver	поставлять	V
expand	расширять	V
read	читать	V
accomplish	выполнять	V
obey	повиноваться	V
comprehend	постигать	V
portray	изобразить	V
realize	реализовать	V
sink	потопить	V
inquire	спрашивать	V
leave	оставлять	V
shrink	сокращаться	V
get	получать	V
keep	держать	V
investigate	расследовать	V
sign	подписывать	V
cherish	лелеять	V
build	строить	V
appoint	назначать	V
carry	нести	V
save	сохранять	V
elect	избирать	V
examine	исследовать	V
fall	падать	V
hang	висеть	V
hear	слышать	V
feel	чувствовать	V
disorganize	дезорганизовать	V
pursue	преследовать	V
shed	пролить	V
restore	восстанавливать	V
enjoy	наслаждаться	V
argue	спорить	V
acquire	приобретать	V
justify	оправдывать	V
do	делать	V
write	писать	V
achieve	достигать	V
behave	вести себя	V
seem	казаться	V
forget	забывать	V
conclude	заключать	V
walk	ходить	V
satisfy	удовлетворять	V
paint	покрасить	V
go	идти	V
plead	умолять	V
inform	сообщить	V
buy	купить	V
sleep	спать	V
meet	встречаться	V
forgive	прощать	V
please	радовать	V
disappear	исчезать	V
participate	участвовать	V
swim	плавать	V
become	становиться	V
absorb	поглощать	V
steal	красть	V
add	добавлять	V
remind	напоминать	V
prove	доказывать	V
glitter	блестеть	V
appear	появляться	V
find	находить	V
take	принимать	V
ask	просить	V
marry	жениться	V
reduce	уменьшить	V
sit	сидеть	V
beg	просить	V
wash	мыть	V
explain	объяснять	V
contemplate	созерцать	V
wander	блуждать	V
allow	позволять	V
pray	молиться	V
attend	присутствовать	V
verify	проверять	V
determine	определять	V
grow	расти	V
succeed	преуспевать	V
kill	убивать	V
remain	оставаться	V
blur	затемнить	V
imitate	подражать	V
lose	терять	V
roam	бродить	V
multiply	умножить	V
learn	учиться	V
lock	запирать	V
compare	сравнивать	V
eat	есть	V
borrow	заимствовать	V
occur	происходить	V
try	пытаться	V
join	присоединиться	V
vanish	исчезать	V
deserve	заслуживать	V
assume	предполагать	V
put	класть	V
recommend	рекомендовать	V
discover	открывать	V
run	работать	V
think	думать	V
create	создавать	V
proclaim	провозглашать	V
come	приехать	V
encourage	поощрять	V
live	жить	V
agree	соглашаться	V
speak	говорить	V
differ	отличаться	V
locate	размещать	V
engage	заниматься	V
want	нуждаться	V
communicate	сообщить	V
ignore	игнорировать	V
accept	принимать	V
quit	бросать	V
discourage	отговаривать	V
declare	объявлять	V
evaluate	оценивать	V
dominate	доминировать	V
win	выигрывать	V
advise	консультировать	V
withdraw	изымать	V
make	делать	V
give	давать	V
divide	делить	V
overcome	преодолевать	V
analyze	анализировать	V
imagine	вообразить	V
require	требовать	V
discuss	обсуждать	V
inspect	инспектировать	V
acknowledge	признавать	V
obtain	получать	V
stand	стоять	V
cooperate	сотрудничать	V
hold	занимать	V
destroy	уничтожать	V
handle	обращаться	V
begin	начинать	V
abandon	отказываться от	V
earn	зарабатывать	V
greet	приветствовать	V
complain	жаловаться	V
listen	прослушать	V
rationalize	рационализировать	V
avoid	избежать	V
originate	происходить	V
receive	получать	V
pretend	претендовать	V
explore	исследовать	V
sell	продавать	V
stop	остановить	V
reject	отклонять	V
relax	отдыхать	V
persuade	убеждать	V
lick	лизать	V
bring	приносить	V
sing	петь	V
fly	летать	V
retain	удерживать	V
arrive	приехать	V
say	сказать	V
organize	организовать	V
choose	выбирать	V
lend	предоставлять	V
breathe	дышать	V
entertain	развлекать	V
burn	сжигать	V
knit	вязать	V
draw	рисовать	V
clarify	прояснить	V
post	вывешивать	V
owe	быть должным	V
attach	прикреплять	V
know	знать	V
arrange	договориться	V
bear	нести	V
curl	виться	V
decide	решать	V
happen	происходить	V
construct	строить	V
notify	уведомлять	V
believe	полагать	V
defend	защищать	V
gather	собирать	V
announce	объявлять	V
send	отправлять	V
collect	собирать	V
